ua_no,ua,year,area,population,pop_change,pop_change_percent,pop_male,pop_female
1,Greater Mumbai U.A.,1961,539.8299999999999,4515495,1298591,40.37,2694748,1820747
1,Greater Mumbai U.A.,1971,559.99,6596370,2080875,46.08,3820973,2775397
1,Greater Mumbai U.A.,1981,588.5,9421962,2825592,42.84,5290416,4131546
1,Greater Mumbai U.A.,1991,1040.9,12596243,3174281,33.69,6891222,5705021
1,Greater Mumbai U.A.,2001,1135.11,16434386,3838143,30.47,9021789,7412597
1,Greater Mumbai U.A.,2011,1063.49,18394912,1960526,11.93,9872271,8522641
2,Delhi  U.A.,1961,326.54999999999995,2359408,922274,64.17453069790291,1327386,1032022
2,Delhi  U.A.,1971,446.26,3647023,1287615,54.57364728779422,2028091,1618932
2,Delhi  U.A.,1981,580.9499999999999,5760811,2113788,57.95927253543507,3186119,2574692
2,Delhi  U.A.,1991,685.34,8471625,2710814,47.06,4630456,3841169
2,Delhi  U.A.,2001,912.52,12895547,4423922,52.22,7079670,5815877
2,Delhi  U.A.,2011,1139.48,16349831,3454284,26.786641931513255,8750834,7598997
3,Kolkata U.A.,1961,610.5,6008656,1322787,28.229278283281072,3629405,2379251
3,Kolkata U.A.,1971,679.36,7447429,1438773,23.94500533896432,4369095,3078334
3,Kolkata U.A.,1981,870.35,9232103,1784674,23.96362556796446,5181471,4050632
3,Kolkata U.A.,1991,920.65,11110314,1878211,20.344346244837173,6067548,5042766
3,Kolkata U.A.,2001,1046.46,13251339,2141025,19.270607473380142,7086998,6164341
3,Kolkata U.A.,2011,1056.1293999999998,14057991,806652,6.087324458305686,7263384,6794607
4,Chennai U.A. $,1961,226.07,1944502,402169,26.075367641099557,1022115,922387
4,Chennai U.A. $,1971,490.5800000000001,3155944,1211442,62.300887322306686,1658344,1497600
4,Chennai U.A. $,1981,531.82,4273329,1117385,35.405729632718455,2214213,2059116
4,Chennai U.A. $,1991,580.0600000000001,5416903,1143574,26.760729164545953,2803085,2613818
4,Chennai U.A. $,2001,788.6900000000002,6686140,1269237,23.43104537777398,3419947,3266193
4,Chennai U.A. $,2011,932.4739999999998,8653521,1967381,29.424765260673574,4358612,4294909
5,Bruhat Bangalore U.A.,1961,501.2099999999999,1206961,420618,53.49039795610821,644047,562914
5,Bruhat Bangalore U.A.,1971,177.3,1664208,457247,37.88415698601696,887782,776426
5,Bruhat Bangalore U.A.,1981,365.65,2921751,1257543,75.56405208964264,1541397,1380354
5,Bruhat Bangalore U.A.,1991,449.69630000000006,4137314,1215563,41.6039217578774,2174728,1962586
5,Bruhat Bangalore U.A.,2001,539.85,5701446,1564132,37.80549409592794,2988561,2712885
5,Bruhat Bangalore U.A.,2011,748.42,8520435,2818989,49.44340435742092,4433855,4086580
6,Hyderabad U.A.  @,1961,NA,1254941,119183,10.493696720604213,650567,604374
6,Hyderabad U.A.  @,1971,NA,1815117,560176,44.63763635103164,946947,868170
6,Hyderabad U.A.  @,1981,NA,2607770,792653,43.67,1359181,1248589
6,Hyderabad U.A.  @,1991,NA,4344437,1736667,66.6,2251452,2092985
6,Hyderabad U.A.  @,2001,838.03,5756729,1412292,32.508055704340975,2981245,2775484
6,Hyderabad U.A.  @,2011,1225.59,7677018,1920289,33.35729369925178,3928408,3748610
7,Ahmadabad U.A.,1961,156.07,1265081,340517,36.83000852293621,700005,565076
7,Ahmadabad U.A.,1971,296.09,1871006,605925,47.89614261853588,1021470,849536
7,Ahmadabad U.A.,1981,336.03,2733952,862946,46.122032746020054,1461834,1272118
7,Ahmadabad U.A.,1991,425.17,3631233,897281,32.81992514864928,1921611,1709622
7,Ahmadabad U.A.,2001,613.81,4912912,1281679,35.29597246995718,2607201,2305711
7,Ahmadabad U.A.,2011,1060.9500000000003,6357693,1444781,29.407833887519256,3348869,3008824
8,Pune U.A.,1961,282.18,790798,182164,29.93,424439,366359
8,Pune U.A.,1971,324.52,1135034,344236,43.53,609920,525114
8,Pune U.A.,1981,357.39,1722186,587152,51.73,916129,806057
8,Pune U.A.,1991,423.42,2493987,771801,44.82,1310514,1183473
8,Pune U.A.,2001,675.66,3768612,1274625,51.11,1984906,1783706
8,Pune U.A.,2011,502.78,5057709,1289097,34.21,2656240,2401469
9,Surat U.A.,1961,24.01,317519,80125,33.75190611388662,165250,152269
9,Surat U.A.,1971,49.37,493001,175482,55.26661396640831,261736,231265
9,Surat U.A.,1981,92.58,930246,437245,88.69048947162379,505551,424695
9,Surat U.A.,1991,114.07,1514545,584299,62.81123487765602,823198,691347
9,Surat U.A.,2001,289.83,2820373,1305828,86.2191615303606,1602049,1218324
9,Surat U.A.,2011,431.01000000000005,4591246,1770873,62.78860987536046,2619373,1971873
10,Jaipur *,1961,104.4,410376,105996,34.823575793416126,221118,189258
10,Jaipur *,1971,258.57,636768,226392,55.16696882858647,342836,293932
10,Jaipur *,1981,210.09,1015160,378392,59.42384039398965,545462,469698
10,Jaipur *,1991,218.26,1518235,503075,49.55622758973955,812589,705646
10,Jaipur *,2001,484.64,2322575,804340,52.97862320391771,1237765,1084810
10,Jaipur *,2011,484.64,3046163,723588,31.154559056219927,1603125,1443038
11,Kanpur U.A.,1961,296.66,971062,265679,37.66,558490,412572
11,Kanpur U.A.,1971,298.98,1275242,304180,31.32,723641,551601
11,Kanpur U.A.,1981,298.98,1639064,363822,28.53,908707,730357
11,Kanpur U.A.,1991,298.98,2029889,390825,23.84,1114225,915664
11,Kanpur U.A.,2001,301.02,2715555,685666,33.78,1465142,1250413
11,Kanpur U.A.,2011,301.16,2920496,204941,7.546928712546791,1572334,1348162
12,Lucknow U.A.,1961,135.43,655673,158812,31.96,366501,289172
12,Lucknow U.A.,1971,127.66,813982,158309,24.14,445277,368705
12,Lucknow U.A.,1981,145.94,1007604,193622,23.79,550106,457498
12,Lucknow U.A.,1991,337.5,1669204,661600,65.66,892308,776896
12,Lucknow U.A.,2001,337.5,2245509,576305,34.53,1189466,1056043
12,Lucknow U.A.,2011,393.6,2902920,657411,29.276702965786377,1509451,1393469
13,Nagpur U.A.,1961,217.56,643659,194560,43.322296420165706,341654,302005
13,Nagpur U.A.,1971,217.56,866076,222417,34.55509827408612,456149,409927
13,Nagpur U.A.,1981,217.56,1219461,353385,40.80300112230336,636728,582733
13,Nagpur U.A.,1991,228.81,1664006,444545,36.45422034817022,868767,795239
13,Nagpur U.A.,2001,229.2,2129500,465494,27.974298169597944,1102009,1027491
13,Nagpur U.A.,2011,229.2,2497870,368370,17.29842686076544,1274138,1223732
14,Ghaziabad U.A.,1961,11.68,70438,26693,61.01954509086753,39014,31424
14,Ghaziabad U.A.,1971,38.22,137033,66595,94.54413810727165,76438,60595
14,Ghaziabad U.A.,1981,68.39999999999999,297429,160396,117.04917793524187,166020,131409
14,Ghaziabad U.A.,1991,79.89,578680,281251,94.5607186925283,317422,261258
14,Ghaziabad U.A.,2001,161.21,1217543,638863,110.4000483859819,655924,561619
14,Ghaziabad U.A.,2011,263.29,2375820,1158277,95.1323279752748,1263392,1112428
15,Indore U.A.,1961,55.84,394941,84082,27.05,213346,181595
15,Indore U.A.,1971,58.72,560936,165995,42.03,301127,259809
15,Indore U.A.,1981,113.52,829327,268391,47.85,439916,389411
15,Indore U.A.,1991,165.17,1109056,279729,33.729638610584246,583653,525403
15,Indore U.A.,2001,165.17,1516918,407862,36.775600150037505,796673,720245
15,Indore U.A.,2011,233.6,2170295,653377,43.072664441980386,1127910,1042385
16,Coimbatore U.A. $,1961,169.7,453601,166267,57.86541098512532,238567,215034
16,Coimbatore U.A. $,1971,298.95,736203,282602,62.30189086884729,385595,350608
16,Coimbatore U.A. $,1981,290.73,920355,184152,25.013753000191524,478442,441913
16,Coimbatore U.A. $,1991,317.23,1100746,180391,19.60015428829093,570370,530376
16,Coimbatore U.A. $,2001,598.12,1601194,500448,45.46443957098186,819274,781920
16,Coimbatore U.A. $,2011,696.247,2136916,535722,33.45765722329712,1071435,1065481
17,Kochi U.A.,1961,110.72,365806,131628,56.20852513899683,188222,177584
17,Kochi U.A.,1971,176.95,607339,241533,66.02762119812141,310571,296768
17,Kochi U.A.,1981,322.77,937744,330405,54.402071989449055,470460,467284
17,Kochi U.A.,1991,426.67,1242115,304371,32.45779231858588,620793,621322
17,Kochi U.A.,2001,477.08,1410666,168551,13.569677525832955,696930,713736
17,Kochi U.A.,2011,843.84,2119724,709058,50.26405967110571,1044243,1075481
18,Patna U.A.,1961,79.87,435360,93449,27.331381558358753,244371,190989
18,Patna U.A.,1971,97.01,575476,140116,32.18393972804116,319506,255970
18,Patna U.A.,1981,112.24,953064,377588,65.61316197373999,524654,428410
18,Patna U.A.,1991,132.27,1140100,187036,19.624705161458202,622920,517180
18,Patna U.A.,2001,135.19,1697976,557876,48.93219892991843,922971,775005
18,Patna U.A.,2011,142.46,2049156,351180,20.6822711275071,1087285,961871
19,Kozhikode U.A.,1961,110.15,348587,120435,52.78717696973947,176201,172386
19,Kozhikode U.A.,1971,188.83,534742,186155,53.40273733673373,268400,266342
19,Kozhikode U.A.,1981,159.69,610232,75490,14.117088240684291,303874,306358
19,Kozhikode U.A.,1991,339.67,945802,335570,54.99,467659,478143
19,Kozhikode U.A.,2001,334.9400000000001,1101157,155355,16.43,535726,565431
19,Kozhikode U.A.,2011,909.7900000000005,2028399,927242,84.20615770503207,964960,1063439
20,Bhopal U.A.,1961,94.72,222948,120615,117.87,125875,97073
20,Bhopal U.A.,1971,122.76,384859,161911,72.62,211273,173586
20,Bhopal U.A.,1981,284.9,671018,286159,74.35,358907,312111
20,Bhopal U.A.,1991,284.9,1062771,391753,58.38,561208,501563
20,Bhopal U.A.,2001,298.48,1458416,395645,37.23,768391,690025
20,Bhopal U.A.,2011,336.06,1886100,427684,29.325240534936537,981860,904240
21,Thrissur U.A.,1961,63.21,157282,29334,22.926501391190172,75957,81325
21,Thrissur U.A.,1971,65.92,205038,47756,30.363296499281546,98704,106334
21,Thrissur U.A.,1981,189.96,472889,267851,130.6348091573269,228011,244878
21,Thrissur U.A.,1991,252.65,627063,154174,32.60257692608624,302611,324452
21,Thrissur U.A.,2001,310.49,773598,146535,23.368465369508325,371495,402103
21,Thrissur U.A.,2011,990.91,1861269,1087671,140.59899327557724,879643,981626
22,Vadodara U.A.,1961,34.42,309716,98309,46.502244485754964,166858,142858
22,Vadodara U.A.,1971,87.71,478524,168808,54.5041263609242,258431,220093
22,Vadodara U.A.,1981,132.54,776182,297658,62.203358661216576,411212,364970
22,Vadodara U.A.,1991,NA,1127903,351721,45.31424330891466,594616,533287
22,Vadodara U.A.,2001,213.88,1491045,363142,32.196208361889276,782251,708794
22,Vadodara U.A.,2011,310.35,1822221,331176,22.210999668018065,949998,872223
23,Agra U.A.,1961,88.82,508680,133015,35.41,278953,229727
23,Agra U.A.,1971,87.75,634622,125942,24.76,345642,288980
23,Agra U.A.,1981,82.22,747318,112696,17.76,402353,344965
23,Agra U.A.,1991,145.36,961420,214102,28.649383528832438,518220,443200
23,Agra U.A.,2001,149.37,1374493,413073,42.96488527386574,743948,630545
23,Agra U.A.,2011,166.21,1760285,385792,28.067949418440108,939875,820410
24,Visakhapatnam @,1961,29.14,211190,103148,95.47028007626663,110545,100645
24,Visakhapatnam @,1971,94.53,363467,152277,72.10426630048771,189084,174383
24,Visakhapatnam @,1981,96.54,603630,240163,66.07559971056519,312224,291406
24,Visakhapatnam @,1991,310.97,1044119,440489,72.97334459851234,539201,504918
24,Visakhapatnam @,2001,325.83,1345938,301819,28.90657099430237,687985,657953
24,Visakhapatnam @,2011,513.61,1728128,382190,28.39581020819681,873599,854529
25,Malappuram U.A.,1961,27.299999999999997,48650,2857,6.238944816893412,23617,25033
25,Malappuram U.A.,1971,72.78,115731,67081,137.88489208633095,57024,58707
25,Malappuram U.A.,1981,112.57,177774,62043,53.609663789304506,87748,90026
25,Malappuram U.A.,1991,137.11,243427,65653,36.93059727519209,119951,123476
25,Malappuram U.A.,2001,152.67000000000002,311558,68131,27.988267529896028,151291,160267
25,Malappuram U.A.,2011,819.39,1699060,1387502,445.34308218694434,808406,890654
26,Thiruvananthapuram U.A.,1961,112.9,340138,110653,48.21796631588121,172440,167698
26,Thiruvananthapuram U.A.,1971,118.75,501151,161013,47.33755122920697,251473,249678
26,Thiruvananthapuram U.A.,1981,150.14000000000001,621752,120601,24.064802823899385,308944,312808
26,Thiruvananthapuram U.A.,1991,242.07,959256,337504,54.28273652517402,473787,485469
26,Thiruvananthapuram U.A.,2001,256.22,1050933,91677,9.557094248042233,515443,535490
26,Thiruvananthapuram U.A.,2011,542.57,1679754,628821,59.83454701679365,813065,866689
27,Kannur U.A.,1961,96.39000000000001,211193,128722,156.08153168992737,105626,105567
27,Kannur U.A.,1971,82.98,210975,-218,-0.10322311819047034,105129,105846
27,Kannur U.A.,1981,276.6,612659,401684,190.39412252636566,300569,312090
27,Kannur U.A.,1991,647.1399999999999,1145476,532817,86.96795444121445,553225,592251
27,Kannur U.A.,2001,638.9499999999997,1212898,67422,5.885937374506319,574273,638625
27,Kannur U.A.,2011,1003.6599999999996,1640986,428088,35.294641429040205,755764,885222
28,Ludhiana,1961,19.66,244032,90237,58.673558958353645,133443,110589
28,Ludhiana,1971,41.7,401176,157144,64.39483346446369,222052,179124
28,Ludhiana,1981,110,607052,205876,51.31812471334278,334390,272662
28,Ludhiana,1991,134.67,1042740,435688,71.77111680712692,580961,461779
28,Ludhiana,2001,159.37,1398467,355727,34.11464027466098,793142,605325
28,Ludhiana,2011,159.37,1618879,220412,15.76,874908,743971
29,Nashik U.A.,1961,127.79,215576,58688,37.407577380041815,117628,97948
29,Nashik U.A.,1971,132.97,271681,56105,26.025624373770732,145059,126622
29,Nashik U.A.,1981,165.2,443003,171322,63.05998579216065,241108,201895
29,Nashik U.A.,1991,321.94,725341,282338,63.73275124547689,383835,341506
29,Nashik U.A.,2001,321.98,1152326,426985,58.866795066044794,616088,536238
29,Nashik U.A.,2011,321.98,1561809,409483,35.53534329694895,821921,739888
30,Vijayawada U.A.@,1961,48.099999999999994,269536,83142,44.61,138249,131287
30,Vijayawada U.A.@,1971,89.1,395084,125548,46.579306660334794,203584,191500
30,Vijayawada U.A.@,1981,105.3,613722,218638,55.34,313651,300071
30,Vijayawada U.A.@,1991,104.71,845756,232034,37.81,430145,415611
30,Vijayawada U.A.@,2001,101.2,1039518,193762,22.91,527307,512211
30,Vijayawada U.A.@,2011,283.58,1476931,437413,42.07844404810691,743267,733664
31,Madurai U.A. $,1961,88.89,490882,120091,32.38778719008822,251040,239842
31,Madurai U.A. $,1971,104.24,701904,211022,42.988335282206315,359717,342187
31,Madurai U.A. $,1981,104.26999999999998,899303,197399,28.123361599307028,460763,438540
31,Madurai U.A. $,1991,110.21,1077158,177855,19.776982841155874,551296,525862
31,Madurai U.A. $,2001,143.43,1220898,143740,13.3443747342544,617630,603268
31,Madurai U.A. $,2011,151.33999999999997,1465625,244727,20.044835850333115,733821,731804
32,Varanasi U.A.,1961,88.84,505952,136153,36.81810929721281,279337,226615
32,Varanasi U.A.,1971,91.58,635175,129223,25.540565112896086,348414,286761
32,Varanasi U.A.,1981,105.87,803365,168190,26.47931672373755,436146,367219
32,Varanasi U.A.,1991,106.82,1039939,236574,29.447884834415238,558818,481121
32,Varanasi U.A.,2001,114.31,1216392,176453,16.967629832134385,649684,566708
32,Varanasi U.A.,2011,118.68,1432280,215888,17.748225900860906,758993,673287
33,Meerut U.A.,1961,59.13,294853,49674,20.26,163447,131406
33,Meerut U.A.,1971,57.27,383106,88253,29.93,211010,172096
33,Meerut U.A.,1981,82.44,542998,159892,41.74,293746,249252
33,Meerut U.A.,1991,177.58,849799,306801,56.5,454204,395595
33,Meerut U.A.,2001,183.64,1172106,322307,37.92743931211969,627031,545075
33,Meerut U.A.,2011,186.61,1420902,248796,21.226407850484513,752893,668009
34,Faridabad,1961,25.75,59039,21646,57.88783997004787,32285,26754
34,Faridabad,1971,25.75,122817,63778,108.02689747455072,70030,52787
34,Faridabad,1981,178.24,330864,208047,169.3959305307897,190183,140681
34,Faridabad,1991,178.24,617717,286853,86.69815996905072,342481,275236
34,Faridabad,2001,198.75,1055938,438221,70.94203332594053,581069,474869
34,Faridabad,2011,204,1414050,358112,33.91411238159816,754542,659508
35,Rajkot U.A.,1961,NA,194145,62076,47.00270313245349,100735,93410
35,Rajkot U.A.,1971,60.15,300612,106467,54.838909062813876,156528,144084
35,Rajkot U.A.,1981,69,445076,144464,48.056631139142816,231218,213858
35,Rajkot U.A.,1991,NA,654490,209414,47.051290116744106,340270,314220
35,Rajkot U.A.,2001,163.14,1003015,348525,53.25138657580711,525898,477117
35,Rajkot U.A.,2011,185.38,1390640,387625,38.64598236317503,729762,660878
36,Jamshedpur U.A.,1961,79,328044,109882,50.36715835021681,183841,144203
36,Jamshedpur U.A.,1971,128.02,440426,112382,34.25820926461085,245563,194863
36,Jamshedpur U.A.,1981,150.69,680054,239628,54.40823202989833,369252,310802
36,Jamshedpur U.A.,1991,159.55,829171,149117,21.927229308260817,446770,382401
36,Jamshedpur U.A.,2001,159.55,1104713,275542,33.23102231023516,581829,522884
36,Jamshedpur U.A.,2011,184.07,1339438,234725,21.247600055399005,697926,641512
37,Jabalpur U.A.,1961,173.25,367014,110016,42.81,202874,164140
37,Jabalpur U.A.,1971,221.51,534845,167831,45.73,294568,240277
37,Jabalpur U.A.,1981,230.64,757303,222458,41.59,409634,347669
37,Jabalpur U.A.,1991,224.45,888916,131613,17.38,472324,416592
37,Jabalpur U.A.,2001,205.15,1098000,209084,23.52,580038,517962
37,Jabalpur U.A.,2011,237.16,1268848,170848,15.55992714025501,661436,607412
38,Srinagar U.A.,1961,50.96,297421,41690,16.3,159700,137721
38,Srinagar U.A.,1971,107.17,431835,134414,45.19,232786,199049
38,Srinagar U.A.,1981,210.65,616835,185000,42.84,329737,287098
38,Srinagar U.A.,1991,NA,NA,NA,NA,NA,NA
38,Srinagar U.A.,2001,242.6,988210,NA,NA,537512,450698
38,Srinagar U.A.,2011,304.27,1264202,275992,27.92847674077372,667203,596999
39,Asansol U.A.!,1961,63.3,286539,104435,57.34909721917146,169401,117138
39,Asansol U.A.!,1971,73.44,370800,84261,29.40646822945568,210127,160673
39,Asansol U.A.!,1981,149.01,628991,258191,69.63079827400216,353105,275886
39,Asansol U.A.!,1991,280.74,938067,309076,49.13838194823138,512611,425456
39,Asansol U.A.!,2001,351.93,1067369,129302,13.78387684461771,564837,502532
39,Asansol U.A.!,2011,369.34320000000014,1243414,176045,16.49335890399665,646052,597362
40,Vasai-Virar City [9],1961,22.560000000000002,37651,10778,40.10717076619655,19759,17892
40,Vasai-Virar City [9],1971,26.58,57622,19971,53.04241587208839,30300,27322
40,Vasai-Virar City [9],1981,27.410000000000004,80038,22416,38.90180833709347,41917,38121
40,Vasai-Virar City [9],1991,50.690000000000005,215762,135724,169.57445213523576,113431,102331
40,Vasai-Virar City [9],2001,74.55,518601,302839,140.3578943465485,276682,241919
40,Vasai-Virar City [9],2011,319.39,1222390,703789,135.7091482662008,648172,574218
41,Allahabad U.A.,1961,81.46,430730,98435,29.62,242191,188539
41,Allahabad U.A.,1971,82.18,513036,82306,19.11,287506,225530
41,Allahabad U.A.,1981,82.18,650070,137034,26.71,358943,291127
41,Allahabad U.A.,1991,82.18,844546,194476,29.92,465925,378621
41,Allahabad U.A.,2001,85.69,1042229,197683,23.41,576122,466107
41,Allahabad U.A.,2011,115.46,1212395,170166,16.327121966477616,654487,557908
42,Dhanbad U.A.,1961,124.2,223843,150241,204.12624656938672,136519,87324
42,Dhanbad U.A.,1971,202.29,456276,232433,103.83751111269952,273508,182768
42,Dhanbad U.A.,1981,208.59,689460,233184,51.10590958104305,397454,292006
42,Dhanbad U.A.,1991,207.99,828301,138841,20.137643953238765,470014,358287
42,Dhanbad U.A.,2001,223.06,1065327,237026,28.615925853041347,579150,486177
42,Dhanbad U.A.,2011,240.66,1196214,130887,12.286086807149355,632522,563692
43,Aurangabad U.A.,1961,50.56,97701,31065,46.6189447145687,52758,44943
43,Aurangabad U.A.,1971,50.48,165253,67552,69.1415645694517,91230,74023
43,Aurangabad U.A.,1981,50.48,316421,151168,91.47670541533284,170347,146074
43,Aurangabad U.A.,1991,148.12,592709,276288,87.3165813899836,316288,276421
43,Aurangabad U.A.,2001,148.12,892483,299774,50.57692729484452,469237,423246
43,Aurangabad U.A.,2011,148.12,1193167,300684,33.69072576172319,618845,574322
44,Amritsar U.A.,1961,NA,390055,53941,16.048424046603234,216851,173204
44,Amritsar U.A.,1971,NA,454805,64750,16.600223045467946,248924,205881
44,Amritsar U.A.,1981,NA,594844,140039,30.79099833994789,321086,273758
44,Amritsar U.A.,1991,NA,708835,113991,19.163175555271632,376478,332357
44,Amritsar U.A.,2001,NA,1003917,295082,41.62915205936501,538744,465173
44,Amritsar U.A.,2011,NA,1183549,179632,17.89311267764168,628420,555129
45,Jodhpur U.A.,1961,75.5,224760,44043,24.371254502896793,121712,103048
45,Jodhpur U.A.,1971,230.18,317612,92852,41.31162128492614,171039,146573
45,Jodhpur U.A.,1981,78.57,506345,188733,59.422502928100954,270486,235859
45,Jodhpur U.A.,1991,78.6,666279,159934,31.585973990066062,361078,305201
45,Jodhpur U.A.,2001,90.34,860818,194539,29.197828537294434,459198,401620
45,Jodhpur U.A.,2011,132.97,1138300,277482,32.23468840103251,598795,539505
46,Ranchi U.A.,1961,39.86,140253,33404,31.262810133927317,78273,61980
46,Ranchi U.A.,1971,94.88,266545,126292,90.04584572166014,147765,118780
46,Ranchi U.A.,1981,182.09,502771,236226,88.6251852407661,275823,226948
46,Ranchi U.A.,1991,182.09,614795,112024,22.281316941510152,331253,283542
46,Ranchi U.A.,2001,182.09,863495,248700,40.45250855976382,459462,404033
46,Ranchi U.A.,2011,197.36,1126720,263225,30.483673906623665,586596,540124
47,Raipur U.A.,1961,25.17,139792,49988,55.66344483541936,73977,65815
47,Raipur U.A.,1971,NA,205986,66194,47.35177978711228,108758,97228
47,Raipur U.A.,1981,55.03,338245,132259,64.2077616925422,176554,161691
47,Raipur U.A.,1991,64.29,462694,124449,36.79256160475395,240921,221773
47,Raipur U.A.,2001,128.05,743494,280800,60.69,387862,355632
47,Raipur U.A.,2011,192.55,1123558,380064,51.12,577992,545566
48,Kollam U.A.,1961,27.55,123291,43354,54.2352102280546,63168,60123
48,Kollam U.A.,1971,29.69,166079,42788,34.70488519032208,83573,82506
48,Kollam U.A.,1981,49.1,246840,80761,48.628062548546175,122187,124653
48,Kollam U.A.,1991,77.24,365130,118290,47.92173067574137,180497,184633
48,Kollam U.A.,2001,78.55000000000001,418743,53613,14.683263495193493,205250,213493
48,Kollam U.A.,2011,364.51000000000005,1110668,691925,165.23858309273228,530167,580501
49,Gwalior U.A.,1961,62.44,300587,59010,24.43,162204,138383
49,Gwalior U.A.,1971,NA,406140,105553,35.12,220269,185871
49,Gwalior U.A.,1981,303.18,555862,149722,36.86,297525,258337
49,Gwalior U.A.,1991,303.18,717780,161918,29.13,388324,329456
49,Gwalior U.A.,2001,180.16,865548,147768,20.59,465057,400491
49,Gwalior U.A.,2011,183.71,1102884,237336,27.420316377601246,588859,514025
50,Durg-Bhilainagar U.A.,1961,124.06,133230,112981,557.9584176996395,83566,49664
50,Durg-Bhilainagar U.A.,1971,135.04,245124,111894,83.98558883134429,134087,111037
50,Durg-Bhilainagar U.A.,1981,159.84,499395,254271,103.73158075096687,266574,232821
50,Durg-Bhilainagar U.A.,1991,202.3,705076,205681,41.186035102473994,374607,330469
50,Durg-Bhilainagar U.A.,2001,340.75,927864,222788,31.597728471824315,482304,445560
50,Durg-Bhilainagar U.A.,2011,335.63,1064222,136358,14.695903710026471,545916,518306
51,Tiruchirappalli U.A. $,1961,72.88,348931,47237,15.657255364707288,178386,170545
51,Tiruchirappalli U.A. $,1971,99.64,465400,116469,33.37880555181397,238820,226580
51,Tiruchirappalli U.A. $,1981,145.85,607986,142586,30.637301246239794,312021,295965
51,Tiruchirappalli U.A. $,1991,170.57,729127,121141,19.924965377492246,371589,357538
51,Tiruchirappalli U.A. $,2001,198.55,887865,158738,21.770967197758413,444928,442937
51,Tiruchirappalli U.A. $,2011,211.50900000000001,1022518,134653,15.165931757643335,507632,514886
52,Kota*,1961,193.58,120345,55238,84.84187568157033,65894,54451
52,Kota*,1971,141.23,212991,92646,76.9836719431634,117318,95673
52,Kota*,1981,221.36,358241,145250,68.19536975740759,195109,163132
52,Kota*,1991,221.36,537371,179130,50.002651846103596,288191,249180
52,Kota*,2001,225.87,703150,165779,30.85000865323957,373094,330056
52,Kota*,2011,527.03,1001694,298544,42.458081490435895,528601,473093
53,Mysore U. A.,1961,37.3,253865,9542,3.9054857708852495,133365,120500
53,Mysore U. A.,1971,37.3,355685,101820,40.10793138085202,186364,169321
53,Mysore U. A.,1981,82.27,479081,123396,34.69249476362512,247323,231758
53,Mysore U. A.,1991,128.42,653345,174264,36.374642283872674,336244,317101
53,Mysore U. A.,2001,124.22,797701,144356,22.094911570456645,405577,392124
53,Mysore U. A.,2011,131.9,990900,193199,24.219475718345592,497138,493762
54,Bareilly U.A.,1961,39.91,272828,64745,31.11,148217,124611
54,Bareilly U.A.,1971,45.48,326106,53278,19.53,177077,149029
54,Bareilly U.A.,1981,49.87,449425,123319,37.82,242405,207020
54,Bareilly U.A.,1991,124.17,617350,167925,37.36,329793,287557
54,Bareilly U.A.,2001,127.03,757979,140629,22.779460597716046,402373,355606
54,Bareilly U.A.,2011,132.05,985752,227773,30.050040964195578,521980,463772
55,Chandigarh  U.A.,1961,32.4,99262,NA,NA,60553,38709
55,Chandigarh  U.A.,1971,57.6,232940,133678,134.67187846305737,132636,100304
55,Chandigarh  U.A.,1981,68.33,422841,189901,81.52356830085,238232,184609
55,Chandigarh  U.A.,1991,78,575829,152988,36.180975827793425,318066,257763
55,Chandigarh  U.A.,2001,79.34,808515,232686,40.40887138369204,450122,358393
55,Chandigarh  U.A.,2011,105.68,970602,162087,20.04749448062188,531051,439551
56,Tiruppur U.A. $,1961,54.86,97965,37500,62.01935003721161,50456,47509
56,Tiruppur U.A. $,1971,71.16000000000001,151127,53162,54.26631960394018,78106,73021
56,Tiruppur U.A. $,1981,90.98000000000002,215859,64732,42.83284919306279,111692,104167
56,Tiruppur U.A. $,1991,90.98000000000002,306237,90378,41.8689978180201,158897,147340
56,Tiruppur U.A. $,2001,197.36,596343,290106,94.7325110943485,310346,285997
56,Tiruppur U.A. $,2011,230.87,963173,366830,61.51325663250847,489200,473973
57,Guwahati U.A.,1961,23.31,136239,92624,212.36730482632123,88882,47357
57,Guwahati U.A.,1971,43.82,200377,64138,47.07756222520717,119740,80637
57,Guwahati U.A.,1981,NA,NA,NA,NA,NA,NA
57,Guwahati U.A.,1991,216.79,584342,NA,NA,327725,256617
57,Guwahati U.A.,2001,216.79,818809,234467,40.124961067320164,446311,372498
57,Guwahati U.A.,2011,219.06,962334,143525,17.52850786935659,498450,463884
58,Solapur [11],1961,22.35,337583,60496,21.83285394118093,177512,160071
58,Solapur [11],1971,23.23,398361,60778,18.003868678221355,208266,190095
58,Solapur [11],1981,25.33,514860,116499,29.244579665178065,266344,248516
58,Solapur [11],1991,33.11,620846,105986,20.585401856815444,319099,301747
58,Solapur [11],2001,178.57,872478,251632,40.53050192801436,444734,427744
58,Solapur [11],2011,178.57,951558,79080,9.063838858974096,481064,470494
59,Hubli-Dharwad,1961,41.18,248489,52309,26.663778162911612,130718,117771
59,Hubli-Dharwad,1971,182.3,379166,130677,52.58864577506449,201286,177880
59,Hubli-Dharwad,1981,190.94,527108,147942,39.01773893228824,275703,251405
59,Hubli-Dharwad,1991,190.94,648298,121190,22.991493204428707,336586,311712
59,Hubli-Dharwad,2001,213.42,786195,137897,21.27061937565749,403085,383110
59,Hubli-Dharwad,2011,213.42,943788,157593,20.045026997119038,474518,469270
60,Salem U.A. $,1961,26.96,273134,70799,34.990980304939825,139649,133485
60,Salem U.A. $,1971,81.39000000000001,410042,136908,50.12484714462499,210329,199713
60,Salem U.A. $,1981,91.96000000000001,511709,101667,24.79428936547963,262175,249534
60,Salem U.A. $,1991,91.04,577260,65551,12.81021049072813,295566,281694
60,Salem U.A. $,2001,108.29,751438,174178,30.173232165748537,382211,369227
60,Salem U.A. $,2011,126.09000000000002,917414,165976,22.08778368940618,462278,455136
61,Aligarh U.A.,1961,31.86,185020,43402,30.65,101376,83644
61,Aligarh U.A.,1971,34.45,252314,67294,36.37,137749,114565
61,Aligarh U.A.,1981,34.05,320861,68547,27.17,171829,149032
61,Aligarh U.A.,1991,34.05,480520,159659,49.76,257390,223130
61,Aligarh U.A.,2001,40.43,669087,188567,39.24,356725,312362
61,Aligarh U.A.,2011,44.93,911223,242136,36.18901577821718,481207,430016
62,Gurgaon U.A.,1961,5.18,37868,19255,103.44920217052598,20269,17599
62,Gurgaon U.A.,1971,15.33,57151,19283,50.921622478081765,30481,26670
62,Gurgaon U.A.,1981,24.13,100877,43726,76.509597382373,53977,46900
62,Gurgaon U.A.,1991,29.88,142651,41774,41.41082704679957,75472,67179
62,Gurgaon U.A.,2001,47.39,239446,96795,67.85441391928553,129612,109834
62,Gurgaon U.A.,2011,198.39,902112,662666,276.74966380728847,488251,413861
63,Moradabad $! Xy,1961,11.65,191828,29974,18.52,103989,87839
63,Moradabad $! Xy,1971,36,272652,80824,42.13,148173,124479
63,Moradabad $! Xy,1981,36,345350,72698,26.66,185855,159495
63,Moradabad $! Xy,1991,36,443701,98351,28.48,236904,206797
63,Moradabad $! Xy,2001,88.68,641583,197882,44.6,340314,301269
63,Moradabad $! Xy,2011,75,887871,246288,38.38755079233708,464580,423291
64,Bhubaneswar  U.A.,1961,50.25,38211,21699,131.41,22580,15631
64,Bhubaneswar  U.A.,1971,65.03,105491,67280,176.07,61190,44301
64,Bhubaneswar  U.A.,1981,92.91,219211,113720,107.8,124820,94391
64,Bhubaneswar  U.A.,1991,124.74,411542,192331,87.74,234897,176645
64,Bhubaneswar  U.A.,2001,148.1,658220,246678,59.94,366134,292086
64,Bhubaneswar  U.A.,2011,185.3,885363,227143,34.50867491112394,468043,417320
65,Jalandhar U.A.,1961,NA,222569,53753,31.841176191830158,120454,102115
65,Jalandhar U.A.,1971,NA,296106,73537,33.04009093809111,159114,136992
65,Jalandhar U.A.,1981,NA,408196,112090,37.854687172836755,220457,187739
65,Jalandhar U.A.,1991,NA,509510,101314,24.819939440856842,272472,237038
65,Jalandhar U.A.,2001,NA,714077,204567,40.14975172224294,383624,330453
65,Jalandhar U.A.,2011,NA,874412,160335,22.453460901275353,463636,410776
66,Warangal U.A.,1961,62.16,156106,22976,17.258318936377975,80928,75178
66,Warangal U.A.,1971,54.98,207520,51414,32.93531318463096,107419,100101
66,Warangal U.A.,1981,54.98,335150,127630,61.50250578257518,173233,161917
66,Warangal U.A.,1991,67.09,467757,132607,39.566462777860664,239352,228405
66,Warangal U.A.,2001,96.79,579216,111459,23.82839807848947,293709,285507
66,Warangal U.A.,2011,242.42,753438,174222,30.078934283583326,377943,375495
67,Bhiwandi U.A.,1961,4.12,47630,21866,84.87036174507064,28890,18740
67,Bhiwandi U.A.,1971,4.12,79576,31946,67.07117363006509,49350,30226
67,Bhiwandi U.A.,1981,9.58,170599,91023,114.38499044938173,104580,66019
67,Bhiwandi U.A.,1991,28.21,392214,221615,129.90404398618983,238254,153960
67,Bhiwandi U.A.,2001,28.21,621427,229213,58.440800175414445,382184,239243
67,Bhiwandi U.A.,2011,28.21,735681,114254,18.385747642120474,431704,303977
68,Dehradun U.A. $,1961,81.01,172478,20542,13.52,97242,75236
68,Dehradun U.A. $,1971,76.77,220571,48093,27.88,124936,95635
68,Dehradun U.A. $,1981,79.91,293010,72439,32.84,162560,130450
68,Dehradun U.A. $,1991,86,368053,75043,25.61107129449507,199554,168499
68,Dehradun U.A. $,2001,102.77000000000001,530263,162210,44.07245695592754,283064,247199
68,Dehradun U.A. $,2011,125.22000000000001,706124,175861,33.16486347340848,372362,333762
69,Siliguri U.A.,1961,15.54,65471,32991,101.57327586206897,39651,25820
69,Siliguri U.A.,1971,15.54,97484,32013,48.896457973759375,56139,41345
69,Siliguri U.A.,1981,61.4,230780,133296,136.73628492880883,127077,103703
69,Siliguri U.A.,1991,61.4,364167,133387,57.798336077649715,196848,167319
69,Siliguri U.A.,2001,41.9,472374,108207,29.713565479573933,250645,221729
69,Siliguri U.A.,2011,130.2064,705579,233205,49.368720547701614,362523,343056
70,Saharanpur,1961,25.25,185213,36778,24.78,101694,83519
70,Saharanpur,1971,25.25,225396,40183,21.7,123027,102369
70,Saharanpur,1981,25.25,295355,69959,31.04,158752,136603
70,Saharanpur,1991,25.36,374945,79590,26.95,199210,175735
70,Saharanpur,2001,25.75,455754,80809,21.55,241508,214246
70,Saharanpur,2011,46.74,705478,249724,54.793594790171895,371740,333738
71,Gorakhpur U.A.,1961,38.85,180255,47819,36.11,102610,77645
71,Gorakhpur U.A.,1971,38.85,230911,50656,28.1,128368,102543
71,Gorakhpur U.A.,1981,48.6,313418,82507,35.73,171092,142326
71,Gorakhpur U.A.,1991,136.58,505566,192148,61.31,273211,232355
71,Gorakhpur U.A.,2001,142.13,632293,126727,25.066361266382632,335088,297205
71,Gorakhpur U.A.,2011,155.23,694889,62596,9.899840738391854,365405,329484
72,Guntur U.A.,1961,30.02,187122,61867,49.39283860923715,94565,92557
72,Guntur U.A.,1971,30.01,269991,82869,44.28608073876936,136695,133296
72,Guntur U.A.,1981,30.01,367699,97708,36.18935445996348,186115,181584
72,Guntur U.A.,1991,30.01,471051,103352,28.107772933839907,238250,232801
72,Guntur U.A.,2001,45.79,514461,43410,9.215562646082908,257775,256686
72,Guntur U.A.,2011,45.79,670073,155612,30.24757950554075,331435,338638
73,Cuttack U.A.,1961,68.89,159786,57281,55.88,93742,66044
73,Cuttack U.A.,1971,104.4,230059,70273,43.98,130738,99321
73,Cuttack U.A.,1981,109.95,327412,97353,42.32,182615,144797
73,Cuttack U.A.,1991,156.94,445746,118334,36.14,247819,197927
73,Cuttack U.A.,2001,195.21,587182,141436,31.73,314101,273081
73,Cuttack U.A.,2011,195.21,663188,76006,12.944197880725227,343938,319250
74,Jammu   U.A.,1961,20.46,108257,24706,29.56996325597539,60566,47691
74,Jammu   U.A.,1971,67.34,164207,55950,51.68257018021929,88627,75580
74,Jammu   U.A.,1981,106.13,239460,75253,45.828131565645805,127123,112337
74,Jammu   U.A.,1991,NA,NA,NA,NA,NA,NA
74,Jammu   U.A.,2001,201.6,612163,NA,NA,334452,277711
74,Jammu   U.A.,2011,198.28,657314,45151,7.375649949441571,352038,305276
75,Puducherry  U.A.,1961,3.98,51762,NA,NA,25560,26202
75,Puducherry  U.A.,1971,29.46,154945,103183,199.34121556354083,78378,76567
75,Puducherry  U.A.,1981,49.54,251420,96475,62.26402917164155,126997,124423
75,Puducherry  U.A.,1991,67.23,401437,150017,59.66788640521836,203859,197578
75,Puducherry  U.A.,2001,72.24,505959,104522,26.036962213248906,253375,252584
75,Puducherry  U.A.,2011,77.26,657209,151250,29.89372656677715,323489,333720
76,Amravati [13],1961,53.36,161715,37651,30.348046169718856,86857,74858
76,Amravati [13],1971,53.36,221277,59562,36.83146275855672,117478,103799
76,Amravati [13],1981,53.36,293755,72478,32.7544209294233,153187,140568
76,Amravati [13],1991,121.65,421576,127821,43.51279127163793,220086,201490
76,Amravati [13],2001,121.65,549510,127934,30.34660417101543,284247,265263
76,Amravati [13],2011,121.65,647057,97547,17.751633273279833,329992,317065
77,Bikaner **,1961,59.75,166772,36479,27.99766679714183,87715,79057
77,Bikaner **,1971,59.75,208894,42122,25.257237425946798,111373,97521
77,Bikaner **,1981,73.79,287712,78818,37.73109806887704,154844,132868
77,Bikaner **,1991,165.75,416289,128577,44.68948114781448,223764,192525
77,Bikaner **,2001,165.75,529690,113401,27.240931180021573,283067,246623
77,Bikaner **,2011,155.03,644406,114716,21.657195718250296,338442,305964
78,Noida,1991,90.43,146514,NA,NA,82772,63742
78,Noida,2001,90.43,305058,158544,108.21,168958,136100
78,Noida,2011,92.1,637272,332214,108.90191373443739,349397,287875
79,Mangalore U.A.,1961,49.21,176003,58920,50.323274941708036,88572,87431
79,Mangalore U.A.,1971,53.74,223335,47332,26.89272341948717,112267,111068
79,Mangalore U.A.,1981,112.99000000000002,332076,108741,48.689636644502656,165911,166165
79,Mangalore U.A.,1991,155.22000000000003,426341,94265,28.38657415772292,212806,213535
79,Mangalore U.A.,2001,200.61,539387,113046,26.515394953804588,269562,269825
79,Mangalore U.A.,2011,205.2541,623841,84454,15.657403682328265,309380,314461
80,Belgaum U.A.,1961,13.99,146790,23997,19.542644939043768,78125,68665
80,Belgaum U.A.,1971,34.84,213872,67082,45.699298317324065,113514,100358
80,Belgaum U.A.,1981,91.13,300372,86500,40.444752001196974,158573,141799
80,Belgaum U.A.,1991,154.95,402412,102040,33.97120903413099,209411,193001
80,Belgaum U.A.,2001,173.23,506480,104068,25.86105782133734,261639,244841
80,Belgaum U.A.,2011,179.1,610350,103870,20.508213552361383,308905,301445
81,Bhavnagar U.A.,1961,NA,176473,38522,27.924407941950403,92085,84388
81,Bhavnagar U.A.,1971,NA,225974,49501,28.050183314161377,118438,107536
81,Bhavnagar U.A.,1981,NA,308642,82668,36.58296972218042,160366,148276
81,Bhavnagar U.A.,1991,NA,405225,96583,31.292889496568836,210363,194862
81,Bhavnagar U.A.,2001,91,517708,112483,27.758159047442778,270278,247430
81,Bhavnagar U.A.,2011,54.14,605882,88174,17.031608551538703,315429,290453
82,Firozabad  &,1961,6.21,98611,33173,50.69378648491703,55114,43497
82,Firozabad  &,1971,6.22,133863,35252,35.74854732230684,73031,60832
82,Firozabad  &,1981,11.48,207135,73272,54.736559019295846,112180,94955
82,Firozabad  &,1991,12.41,270536,63401,30.608540323943323,145401,125135
82,Firozabad  &,2001,29.76,432866,162330,60.0031049472159,230802,202064
82,Firozabad  &,2011,21.35,604214,171348,39.584536554037506,319415,284799
83,Jamnagar U.A.,1961,NA,159217,54798,52.47895497945776,83493,75724
83,Jamnagar U.A.,1971,NA,227640,68423,42.97468235175892,119020,108620
83,Jamnagar U.A.,1981,NA,317362,89722,39.41398699701283,165647,151715
83,Jamnagar U.A.,1991,NA,381646,64284,20.25573320057222,198849,182797
83,Jamnagar U.A.,2001,NA,556956,175310,45.93523841465652,292168,264788
83,Jamnagar U.A.,2011,55.25,600943,43987,7.897751348400951,313214,287729
84,Durgapur U.A.,1961,73.69,41696,NA,NA,31174,10522
84,Durgapur U.A.,1971,154.2,206638,164942,395.58231005372215,117135,89503
84,Durgapur U.A.,1981,154.2,311798,105160,50.89093003223027,169709,142089
84,Durgapur U.A.,1991,154.2,425836,114038,36.57432055369181,233338,192498
84,Durgapur U.A.,2001,154.2,493405,67569,15.867376172986782,263721,229684
84,Durgapur U.A.,2011,162.8927,580990,87585,17.751137503673455,301607,279383
85,Malegaon U.A.,1961,10.44,121408,66386,120.65355675911454,64128,57280
85,Malegaon U.A.,1971,12.95,191847,70439,58.018417237743805,99444,92403
85,Malegaon U.A.,1981,12.95,245883,54036,28.166194936590095,126326,119557
85,Malegaon U.A.,1991,12.95,342595,96712,39.33252807229455,174667,167928
85,Malegaon U.A.,2001,25.04,456054,113459,33.11752944438769,232941,223113
85,Malegaon U.A.,2011,44.2,576642,120588,26.44160559933692,293402,283240
86,Bokaro Steel City U.A.,1961,NA,NA,NA,NA,NA,NA
86,Bokaro Steel City U.A.,1971,178.93,107159,NA,NA,64570,42589
86,Bokaro Steel City U.A.,1981,187.74,264480,157321,146.81081383738183,151476,113004
86,Bokaro Steel City U.A.,1991,183.4,398890,134410,50.82047791893527,222089,176801
86,Bokaro Steel City U.A.,2001,187.55,497780,98890,24.791295845972574,268969,228811
86,Bokaro Steel City U.A.,2011,187.55,564319,66539,13.36715014665113,298480,265839
87,Kolhapur U.A.,1961,70.11,193186,56351,41.18171520444331,102564,90622
87,Kolhapur U.A.,1971,72.78,267513,74327,38.47432008530639,141585,125928
87,Kolhapur U.A.,1981,67.24,351392,83879,31.355111714197065,184874,166518
87,Kolhapur U.A.,1991,67.23,418538,67146,19.108573900373372,218446,200092
87,Kolhapur U.A.,2001,67.23,505541,87003,20.78735980962302,262258,243283
87,Kolhapur U.A.,2011,67.23,561837,56296,11.135793140417888,286938,274899
88,Nellore U.A.,1961,13.68,106776,25296,31.045655375552283,55255,51521
88,Nellore U.A.,1971,13.68,133590,26814,25.112384805574283,68370,65220
88,Nellore U.A.,1981,48.39,237065,103475,77.45714499588291,121211,115854
88,Nellore U.A.,1991,48.39,316606,79541,33.5524012401662,160246,156360
88,Nellore U.A.,2001,87.85,404775,88169,27.84817722974296,203823,200952
88,Nellore U.A.,2011,100.33,558548,153773,37.9897473905256,284154,274394
89,Raurkela   U.A.,1961,95.31,90287,NA,NA,58734,31553
89,Raurkela   U.A.,1971,121.73,172502,82215,91.06,98667,73835
89,Raurkela   U.A.,1981,139.04,322610,150108,87.02,180184,142426
89,Raurkela   U.A.,1991,157.17,398864,76254,23.64,218845,180019
89,Raurkela   U.A.,2001,157.17,484874,86010,21.56,258731,226143
89,Raurkela   U.A.,2011,157.17,552239,67365,13.893300115081445,289925,262314
90,Ajmer U.A.,1961,55.76,231240,34607,17.599792506852868,122561,108679
90,Ajmer U.A.,1971,47.19,264291,33051,14.292942397509082,140113,124178
90,Ajmer U.A.,1981,262.64,375593,111302,42.11342800171023,197851,177742
90,Ajmer U.A.,1991,241.58,402700,27107,7.217120659863204,211102,191598
90,Ajmer U.A.,2001,223.48,490520,87820,21.80779736776757,256695,233825
90,Ajmer U.A.,2011,231.36,551101,60581,12.350362880208758,283072,268029
91,Nanded-Waghala [14],1961,9.66,81087,16063,24.703186515748033,42892,38195
91,Nanded-Waghala [14],1971,12.17,126538,45451,56.052141527001865,67475,59063
91,Nanded-Waghala [14],1981,12.17,191269,64731,51.15538415337685,100333,90936
91,Nanded-Waghala [14],1991,43.93,309316,118047,61.71779012803956,161998,147318
91,Nanded-Waghala [14],2001,46,430733,121417,39.25338488794631,224843,205890
91,Nanded-Waghala [14],2011,58.16,550439,119706,27.791230298119718,285433,265006
92,Jhansi U.A.,1961,60.01,169712,42347,33.24853766733404,92219,77493
92,Jhansi U.A.,1971,60.46,198135,28423,16.747784481945885,104824,93311
92,Jhansi U.A.,1981,72.01,276637,78502,39.62046079693138,146063,130574
92,Jhansi U.A.,1991,74.39,357153,80516,29.10528960334301,190099,167054
92,Jhansi U.A.,2001,83.88,460278,103125,28.87417997328876,244169,216109
92,Jhansi U.A.,2011,194.93,547638,87360,18.979833926453143,289698,257940
93,Gulbarga U. A.,1961,23.31,97069,19880,25.754965085698743,51019,46050
93,Gulbarga U. A.,1971,13.97,145588,48519,49.984031977253295,76538,69050
93,Gulbarga U. A.,1981,28.31,221325,75737,52.02145781245707,116394,104931
93,Gulbarga U. A.,1991,43.16,310920,89595,40.481192815994575,163516,147404
93,Gulbarga U. A.,2001,64.48,430265,119345,38.384471889875215,223594,206671
93,Gulbarga U. A.,2011,64.48,543147,112882,26.235459542375054,276552,266595
94,Erode U.A. $,1961,54.14,119102,49393,70.85598703180364,60883,58219
94,Erode U.A. $,1971,51.63,179388,60286,50.61711810045172,92961,86427
94,Erode U.A. $,1981,64.41,260598,81210,45.270586661315136,135018,125580
94,Erode U.A. $,1991,114.74,337885,77287,29.6575568500142,173830,164055
94,Erode U.A. $,2001,130.47,421744,83859,24.818799295618334,215197,206547
94,Erode U.A. $,2011,137.92999999999998,521891,100147,23.745921696574225,261630,260261
95,Ujjain 22,1961,17.48,144161,14344,11.05,77005,67156
95,Ujjain 22,1971,74.84,208561,64400,44.67,110276,98285
95,Ujjain 22,1981,74.78,282203,73642,35.31,148148,134055
95,Ujjain 22,1991,92.94,362633,80430,28.5,188787,173846
95,Ujjain 22,2001,92.93,431162,68529,18.9,224475,206687
95,Ujjain 22,2011,92.68,515215,84053,19.494528738617966,264871,250344
96,Sangli U.A.,1961,70.94,127183,36672,40.51662228900354,66723,60460
96,Sangli U.A.,1971,63.82,201597,74414,58.50939197848769,106587,95010
96,Sangli U.A.,1981,84.17,268988,67391,33.428572845826075,140496,128492
96,Sangli U.A.,1991,87.77,363751,94763,35.22945261498654,188468,175283
96,Sangli U.A.,2001,120.77,447774,84023,23.099043026685838,229958,217816
96,Sangli U.A.,2011,120.77,513961,66187,14.781340586992545,259320,254641
97,Tirunelveli U.A.,1961,64.44,190048,29119,18.094314884203595,94254,95794
97,Tirunelveli U.A.,1971,74.53999999999999,260945,70897,37.304786159286074,129985,130960
97,Tirunelveli U.A.,1981,74.36,316466,55521,21.276897430493015,157774,158692
97,Tirunelveli U.A.,1991,77.9,359015,42549,13.445046229294775,178982,180033
97,Tirunelveli U.A.,2001,135.26,433352,74337,20.705820091082543,214133,219219
97,Tirunelveli U.A.,2011,135.27,497826,64474,14.877974487252857,245768,252058
98,Muzaffarnagar U.A.,1961,12.04,87622,23409,36.46,48971,38651
98,Muzaffarnagar U.A.,1971,12.04,114783,27161,31,62294,52489
98,Muzaffarnagar U.A.,1981,12.04,171816,57033,49.69,91656,80160
98,Muzaffarnagar U.A.,1991,12.04,247624,75808,44.12,130938,116686
98,Muzaffarnagar U.A.,2001,12.05,331668,84044,33.94,175283,156385
98,Muzaffarnagar U.A.,2011,30.04,495543,163875,49.40934910814429,261130,234413
99,Vellore U.A.,1961,34.2,138499,32475,30.629857390779446,70942,67557
99,Vellore U.A.,1971,31.57,178554,40055,28.920786431670987,91338,87216
99,Vellore U.A.,1981,38.38,256541,77987,43.67698287352846,129581,126960
99,Vellore U.A.,1991,61.74,310776,54235,21.140870270249202,156767,154009
99,Vellore U.A.,2001,148.13,407200,96424,31.02684892012253,203452,203748
99,Vellore U.A.,2011,153.141,484690,77490,19.029960707269154,241201,243489
100,Kurnool  U.A.,1961,NA,100815,40593,67.40559928265418,52029,48786
100,Kurnool  U.A.,1971,15.02,136710,35895,35.604820711203686,69886,66824
100,Kurnool  U.A.,1981,15.02,206362,69652,50.94872357545168,106883,99479
100,Kurnool  U.A.,1991,15.02,275360,68998,33.43541931169498,141604,133756
100,Kurnool  U.A.,2001,46.32,342973,67613,24.554401510749564,174190,168783
100,Kurnool  U.A.,2011,49.32,484327,141354,41.21432299335516,241607,242720
101,Rajahmundry U.A.,1961,18.23,144694,25450,21.342792928784675,72724,71970
101,Rajahmundry U.A.,1971,20.07,183841,39147,27.0550264696532,92654,91187
101,Rajahmundry U.A.,1981,26.73,242834,58993,32.08914224792076,122827,120007
101,Rajahmundry U.A.,1991,59.34,391287,148453,61.13353154830049,197488,193799
101,Rajahmundry U.A.,2001,70.36,413616,22329,5.706552990515913,207869,205747
101,Rajahmundry U.A.,2011,77.94,476873,63257,15.293654017252717,235274,241599
102,Gaya U.A.,1961,30.51,151105,17405,13.017950635751681,82412,68693
102,Gaya U.A.,1971,28.62,179884,28779,19.045696700969525,97418,82466
102,Gaya U.A.,1981,28.62,247075,67191,37.35240488314692,132243,114832
102,Gaya U.A.,1991,28.62,291675,44600,18.05119902863503,156909,134766
102,Gaya U.A.,2001,51.49,394945,103270,35.405845547270076,210410,184535
102,Gaya U.A.,2011,51.49,475987,81042,20.519819215333783,251057,224930
103,Udaipur U.A.,1961,35.97,111139,21518,24.009997656799186,60284,50855
103,Udaipur U.A.,1971,59.21,161278,50139,45.11377644211303,87441,73837
103,Udaipur U.A.,1981,64.1,232588,71310,44.21557807016456,125447,107141
103,Udaipur U.A.,1991,64.28,308571,75983,32.66849536519511,164516,144055
103,Udaipur U.A.,2001,56.92,389438,80867,26.206934546668354,205335,184103
103,Udaipur U.A.,2011,77.57,474531,85093,21.850204653885854,246118,228413
104,Tirupati  U.A.,1961,4.4,35845,10638,42.20256278018011,19230,16615
104,Tirupati  U.A.,1971,67.34,71984,36139,100.82019807504534,38247,33737
104,Tirupati  U.A.,1981,19.68,123897,51913,72.1174149811069,64400,59497
104,Tirupati  U.A.,1991,19.54,188904,65007,52.46858277440132,97721,91183
104,Tirupati  U.A.,2001,50.77,303521,114617,60.6747342565536,155468,148053
104,Tirupati  U.A.,2011,65.68,461900,158379,52.18057399652742,232359,229541
105,Jalgaon,1961,17.72,80351,11939,17.451616675437055,42506,37845
105,Jalgaon,1971,12.3,106711,26360,32.806063396846334,56402,50309
105,Jalgaon,1981,12.44,145335,38624,36.19495647121665,76258,69077
105,Jalgaon,1991,62.29,242193,96858,66.64464857054392,127022,115171
105,Jalgaon,2001,68.24,368618,126425,52.20010487503768,193496,175122
105,Jalgaon,2011,68.24,460228,91610,24.852286106484218,240590,219638
106,Mathura U.A.,1961,21.81,125258,19485,18.42,69038,56220
106,Mathura U.A.,1971,21.81,140150,14892,11.89,76409,63741
106,Mathura U.A.,1981,21.81,159498,19348,13.81,86449,73049
106,Mathura U.A.,1991,21.81,235922,76424,47.92,125161,110761
106,Mathura U.A.,2001,36.43,346791,110869,46.99392171989047,186836,159955
106,Mathura U.A.,2011,65.35,456706,109915,31.69488250848494,244359,212347
107,Cherthala U.A.,1961,16.19,31155,24039,337.8161888701518,15382,15773
107,Cherthala U.A.,1971,16.19,36752,5597,17.96501364147007,18164,18588
107,Cherthala U.A.,1981,22.1,61560,24808,67.50108837614279,30514,31046
107,Cherthala U.A.,1991,170.16,260572,199012,323.2813515269656,127770,132802
107,Cherthala U.A.,2001,146.02,259652,-920,-0.3530694011635939,126609,133043
107,Cherthala U.A.,2011,253.94000000000005,455722,196070,75.51260918460093,222625,233097
108,Bilaspur U.A.,1961,32.35,86706,47607,121.76014731834574,45795,40911
108,Bilaspur U.A.,1971,54.22,136676,49970,57.631536456531265,72026,64650
108,Bilaspur U.A.,1981,46.12,187104,50428,36.89601685738535,97395,89709
108,Bilaspur U.A.,1991,46.47,229615,42511,22.720519069608347,120066,109549
108,Bilaspur U.A.,2001,50.11,335293,105678,46.02399669011171,174351,160942
108,Bilaspur U.A.,2011,68.74,453946,118653,35.38785480162127,233702,220244
109,Patiala U.A.,1961,NA,125234,27365,27.960845620165742,69635,55599
109,Patiala U.A.,1971,NA,151041,25807,20.607023651723978,81646,69395
109,Patiala U.A.,1981,NA,206254,55213,36.55497513920061,109702,96552
109,Patiala U.A.,1991,NA,253706,47452,23.00658411473233,132858,120848
109,Patiala U.A.,2001,NA,323884,70178,27.66115109615066,173682,150202
109,Patiala U.A.,2011,NA,446246,122362,37.77957540353954,236198,210048
110,Panipat U.A.,1961,7.77,67026,12045,21.90756806896928,35566,31460
110,Panipat U.A.,1971,7.77,87981,20955,31.263987109479903,46861,41120
110,Panipat U.A.,1981,20.82,137927,49946,56.76907514122367,73851,64076
110,Panipat U.A.,1991,20.82,191212,53285,38.63275500808398,102261,88951
110,Panipat U.A.,2001,43.81,354148,162936,85.21222517415225,194850,159298
110,Panipat U.A.,2011,43.97,444524,90376,25.519274427640422,237702,206822
111,Kakinada U.A.,1961,24.53,122865,22913,22.924003521690413,62325,60540
111,Kakinada U.A.,1971,30.51,164200,41335,33.642615879217026,82607,81593
111,Kakinada U.A.,1981,49.71,240973,76773,46.7557856272838,121261,119712
111,Kakinada U.A.,1991,58.48,327541,86568,35.924356670664345,163684,163857
111,Kakinada U.A.,2001,67.04,376861,49320,15.057656904021178,187064,189797
111,Kakinada U.A.,2011,78.45,443028,66167,17.557401800663904,217459,225569
112,Davanagere,1961,19.42,78124,22106,39.462315684244345,41606,36518
112,Davanagere,1971,19.42,121110,42986,55.02278429163894,64587,56523
112,Davanagere,1981,20.51,196621,75511,62.349104120221284,103280,93341
112,Davanagere,1991,48.46,287233,90612,46.0845993052624,150484,136749
112,Davanagere,2001,77.12,364523,77290,26.90846803814324,187987,176536
112,Davanagere,2011,77.12,434971,70448,19.32607818985359,219776,215195
113,Kayamkulam U.A.,1961,42.06,83923,41629,98.42767295597484,41159,42764
113,Kayamkulam U.A.,1971,47.78,110895,26972,32.138984545357054,54232,56663
113,Kayamkulam U.A.,1981,34.44,87925,-22970,-20.713287343883856,42883,45042
113,Kayamkulam U.A.,1991,34.44,95450,7525,8.558430480523173,46695,48755
113,Kayamkulam U.A.,2001,34.44,97024,1574,1.6490309062336301,46733,50291
113,Kayamkulam U.A.,2011,215.99999999999997,427967,330943,341.0939561345646,198432,229535
114,Akola,1961,16.39,115760,26154,29.187777604178294,62439,53321
114,Akola,1971,20.88,168438,52678,45.5062197650311,89792,78646
114,Akola,1981,20.88,225412,56974,33.8249088685451,117945,107467
114,Akola,1991,23.44,328034,102622,45.526413855517895,170943,157091
114,Akola,2001,23.44,400520,72486,22.097099690885702,206649,193871
114,Akola,2011,23.44,425817,25297,6.316039149106162,217393,208424
115,Imphal U.A.,1961,17.48,67717,64855,2266.07,34121,33596
115,Imphal U.A.,1971,17.48,100366,32649,48.21,50742,49624
115,Imphal U.A.,1981,38.86,179194,78828,78.5405416176793,90687,88507
115,Imphal U.A.,1991,48.31,237285,58091,32.41793810060605,120874,116411
115,Imphal U.A.,2001,55.51,296239,58954,24.84522831194555,146720,149519
115,Imphal U.A.,2011,74.79,418739,122500,41.35174639395893,204262,214477
116,Bhagalpur U.A.,1961,28.72,143850,29320,25.600279402776565,79183,64667
116,Bhagalpur U.A.,1971,30.17,172202,28352,19.709419534237053,95220,76982
116,Bhagalpur U.A.,1981,30.17,225062,52860,30.69650758992346,122485,102577
116,Bhagalpur U.A.,1991,30.84,260119,35057,15.576596671139509,140227,119892
116,Bhagalpur U.A.,2001,30.84,350133,90014,34.604930820124636,187723,162410
116,Bhagalpur U.A.,2011,30.84,412209,62076,17.72926288010556,219092,193117
117,Thoothukkudi U.A.,1961,24.79,127356,28490,28.816782311411405,64769,62587
117,Thoothukkudi U.A.,1971,82.48,170581,43225,33.94029335092183,86292,84289
117,Thoothukkudi U.A.,1981,82.48,235496,64915,38.05523475650864,120598,114898
117,Thoothukkudi U.A.,1991,82.57,262066,26570,11.282569555321533,132816,129250
117,Thoothukkudi U.A.,2001,53.66,293995,31929,12.18357207726298,147361,146634
117,Thoothukkudi U.A.,2011,102.72,411628,117633,40.011904964370146,205958,205670
118,Bellary,1961,25.9,85673,15351,21.829583913995606,45243,40430
118,Bellary,1971,27.71,125183,39510,46.11721312432155,65528,59655
118,Bellary,1981,65.9,201579,76396,61.02745580470193,103802,97777
118,Bellary,1991,65.9,245391,43812,21.73440685785721,126613,118778
118,Bellary,2001,79.45,316766,71375,29.086233806455823,162699,154067
118,Bellary,2011,79.45,410445,93679,29.57356534476554,206149,204296
119,Agartala #,1961,7.2,54878,12283,28.836717924639043,29281,25597
119,Agartala #,1971,NA,100264,45386,82.70345129195671,51693,48571
119,Agartala #,1981,15.8,132186,31922,31.83794781776111,67120,65066
119,Agartala #,1991,26.81,198320,66134,50.031016900428185,100379,97941
119,Agartala #,2001,34.38,269492,71172,35.887454618797904,135189,134303
119,Agartala #,2011,58.84,400004,130512,48.4288958484853,200132,199872
120,Muzaffarpur U.A.,1961,20.46,109048,35454,48.17512297198141,64322,44726
120,Muzaffarpur U.A.,1971,15.57,126379,17331,15.893001247157216,71909,54470
120,Muzaffarpur U.A.,1981,15.57,190416,64037,50.670601919622726,105586,84830
120,Muzaffarpur U.A.,1991,26.43,241107,50691,26.62118729518528,131556,109551
120,Muzaffarpur U.A.,2001,26.43,305525,64418,26.717598410664145,164000,141525
120,Muzaffarpur U.A.,2011,33.44,396590,91065,29.806071516242532,210025,186565
121,Yamunanagar U.A.,1961,13.88,84337,44710,112.82711282711281,47390,36947
121,Yamunanagar U.A.,1971,43.05,115020,30683,36.38142215160606,63208,51812
121,Yamunanagar U.A.,1981,27.6,160424,45404,39.47487393496783,87605,72819
121,Yamunanagar U.A.,1991,41.57,219754,59330,36.98324440233382,117353,102401
121,Yamunanagar U.A.,2001,46.42,321692,101938,46.387324007754124,174099,147593
121,Yamunanagar U.A.,2011,46.58,383353,61661,19.16771321636845,205298,178055
122,Latur,1961,29.19,40913,5539,15.65839317012495,21443,19470
122,Latur,1971,11.27,70156,29243,71.47605895436658,37663,32493
122,Latur,1981,7.08,111986,41830,59.6242659216603,59279,52707
122,Latur,1991,21,197408,85422,76.27917775436215,104230,93178
122,Latur,2001,21,299985,102577,51.9619265683255,156547,143438
122,Latur,2011,21,382940,82955,27.653049319132624,197737,185203
123,Ahmadnagar U.A.,1961,24.71,119020,13745,13.056281168368558,63122,55898
123,Ahmadnagar U.A.,1971,31.76,148405,29385,24.68912787766762,80491,67914
123,Ahmadnagar U.A.,1981,31.76,181210,32805,22.10505036892288,98105,83105
123,Ahmadnagar U.A.,1991,30.18,222088,40878,22.558357706528337,118050,104038
123,Ahmadnagar U.A.,2001,74.36,355169,133081,59.922643276539034,188704,166465
123,Ahmadnagar U.A.,2011,93.06,379845,24676,6.947678429142183,195467,184378
124,Dhule,1961,26.75,98893,22013,28.632934443288242,52350,46543
124,Dhule,1971,26.75,137129,38236,38.66401059731225,72720,64409
124,Dhule,1981,46.46,210759,73630,53.69396699458174,110869,99890
124,Dhule,1991,46.46,278317,67558,32.05462162944406,145793,132524
124,Dhule,2001,46.46,341755,63438,22.793433387108944,177772,163983
124,Dhule,2011,46.46,375559,33804,9.891296396541382,193446,182113
125,Rohtak  #,1961,11.66,88193,16291,22.65722789352174,47345,40848
125,Rohtak  #,1971,11.66,124755,36562,41.456804961845044,66933,57822
125,Rohtak  #,1981,22.03,166767,42012,33.675604184201035,89300,77467
125,Rohtak  #,1991,28.38,216096,49329,29.579593084962852,114728,101368
125,Rohtak  #,2001,29.58,294577,78481,36.31765511624463,158287,136290
125,Rohtak  #,2011,72.18,374292,79715,27.060836385732763,198237,176055
126,Sagar U.A.,1961,50.06,104676,24608,30.73,56303,48373
126,Sagar U.A.,1971,52.03,154785,50109,47.87,83855,70930
126,Sagar U.A.,1981,52.03,207479,52694,34.04,111563,95916
126,Sagar U.A.,1991,52.07,257119,49640,23.93,137532,119587
126,Sagar U.A.,2001,58.94,308922,51803,20.15,162919,146003
126,Sagar U.A.,2011,62.58,370208,61286,19.83866477622183,194787,175421
127,Korba U.A.,1961,1.45,12424,NA,NA,7285,5139
127,Korba U.A.,1971,14.94,32654,20230,162.83000643915003,17988,14666
127,Korba U.A.,1981,35.07,83387,50733,155.3653457463098,45104,38283
127,Korba U.A.,1991,50.8,146727,63340,75.95908235096599,77907,68820
127,Korba U.A.,2001,215.02,315690,168963,115.15467500868961,164768,150922
127,Korba U.A.,2011,215.91,365253,49563,15.699895467072128,189772,175481
128,Bhilwara *,1961,51.18,43499,7738,21.638097368641816,23617,19882
128,Bhilwara *,1971,119.11,82155,38656,88.86641072208556,44330,37825
128,Bhilwara *,1981,69.93,122625,40470,49.26054409348183,64948,57677
128,Bhilwara *,1991,118.49,183965,61340,50.02242609582059,98132,85833
128,Bhilwara *,2001,118.49,280128,96163,52.27244312776887,148794,131334
128,Bhilwara *,2011,118.49,359483,79355,28.328121430203336,187081,172402
129,Kottayam U.A.,1961,23.96,65574,12376,23.264032482424152,33310,32264
129,Kottayam U.A.,1971,22.97,75429,9855,15.028822399121603,38062,37367
129,Kottayam U.A.,1981,15.55,64431,-10998,-14.580598973869465,32281,32150
129,Kottayam U.A.,1991,63.7,166552,102121,158.49668637767533,83143,83409
129,Kottayam U.A.,2001,64.16,172878,6326,3.7982131706614153,84960,87918
129,Kottayam U.A.,2011,186.64999999999998,357302,184424,106.67869827277039,174182,183120
130,Brahmapur,1961,22.27,76931,14588,23.4,39890,37041
130,Brahmapur,1971,29.27,117662,40731,52.94,60932,56730
130,Brahmapur,1981,76.15,162550,44888,38.15,84467,78083
130,Brahmapur,1991,79.8,210418,47868,29.45,109460,100958
130,Brahmapur,2001,79.8,307792,97374,46.28,160354,147438
130,Brahmapur,2011,79.8,356598,48806,15.85681239278474,185754,170844
131,Shillong U.A.,1961,21.27,102398,43886,75,58082,44316
131,Shillong U.A.,1971,21.27,122752,20354,19.88,66161,56591
131,Shillong U.A.,1981,25.4,174703,51951,42.32,91728,82975
131,Shillong U.A.,1991,25.4,223366,48663,27.85,117373,105993
131,Shillong U.A.,2001,27.05,267662,44296,19.83,134497,133165
131,Shillong U.A.,2011,60.82,354759,87097,32.53991974953486,176725,178034
132,Rampur U.A.,1961,20.2,135407,1130,0.84,73195,62212
132,Rampur U.A.,1971,20.2,161417,26010,19.21,86518,74899
132,Rampur U.A.,1981,20.2,204610,43193,26.76,108024,96586
132,Rampur U.A.,1991,20.2,243742,39132,19.13,127882,115860
132,Rampur U.A.,2001,20.2,281494,37752,15.49,146652,134842
132,Rampur U.A.,2011,27.37,349258,67764,24.0729820173787,182206,167052
133,Shahjahanpur U.A.,1961,19.19,117702,12867,12.27,63016,54686
133,Shahjahanpur U.A.,1971,21.11,144065,26363,22.4,77474,66591
133,Shahjahanpur U.A.,1981,22.76,205095,61030,42.36,110108,94987
133,Shahjahanpur U.A.,1991,22.76,260403,55308,26.97,138317,122086
133,Shahjahanpur U.A.,2001,22.76,321885,61482,23.61,174276,147609
133,Shahjahanpur U.A.,2011,21.12,347852,25967,8.067166845301893,182946,164906
134,Barddhaman U.A.,1961,22.66,108224,32848,43.57885799193377,60478,47746
134,Barddhaman U.A.,1971,22.66,143318,35094,32.427188054405676,79321,63997
134,Barddhaman U.A.,1981,22.68,167364,24046,16.77807393349056,88677,78687
134,Barddhaman U.A.,1991,23.04,245079,77715,46.434717143471715,128520,116559
134,Barddhaman U.A.,2001,23.04,285602,40523,16.534668413042326,148562,137040
134,Barddhaman U.A.,2011,38.9293,346639,61037,21.371348940133473,176391,170248
135,Kadapa U.A.,1961,6.84,49027,11589,30.955179229659702,25377,23650
135,Kadapa U.A.,1971,6.84,66195,17168,35.01743937014298,34362,31833
135,Kadapa U.A.,1981,6.84,103125,36930,55.78971221391343,53452,49673
135,Kadapa U.A.,1991,78.13,215866,112741,109.32460606060606,110603,105263
135,Kadapa U.A.,2001,85.86,262506,46640,21.605996312527214,133224,129282
135,Kadapa U.A.,2011,182.75,344893,82387,31.38480644251941,173314,171579
136,Alwar U.A.,1961,44.76,72707,14839,25.642842330821868,39102,33605
136,Alwar U.A.,1971,40.47,100378,27671,38.05823373265298,54785,45593
136,Alwar U.A.,1981,80,145795,45417,45.245970232521074,80003,65792
136,Alwar U.A.,1991,58.13,210146,64351,44.13800198909428,114177,95969
136,Alwar U.A.,2001,51.38,266203,56057,26.675263864170624,143699,122504
136,Alwar U.A.,2011,61.4,341422,75219,28.256255564362537,180468,160954
137,Anantapur U.A.,1961,18.78,52280,20328,63.62043064596895,27810,24470
137,Anantapur U.A.,1971,18.78,80069,27789,53.15416985462892,42440,37629
137,Anantapur U.A.,1981,16.35,119531,39462,49.284991694663354,62511,57020
137,Anantapur U.A.,1991,16.35,174924,55393,46.34195313349675,90070,84854
137,Anantapur U.A.,2001,51.29,252298,77374,44.23292401271409,128407,123891
137,Anantapur U.A.,2011,67.34,340613,88315,35.00424101657564,171568,169045
138,Bijapur,1961,14.5,78854,13120,19.959229622417624,41205,37649
138,Bijapur,1971,14.5,103931,25077,31.801810941740428,54873,49058
138,Bijapur,1981,44.78,147313,43382,41.74115518950072,76647,70666
138,Bijapur,1991,75.36,193131,45818,31.102482469300043,100474,92657
138,Bijapur,2001,102.59,253891,60760,31.46051125919712,130416,123475
138,Bijapur,2011,98.73,327427,73536,28.96361036822887,165177,162250
139,Ichalkaranji U.A.,1961,22.51,50978,23555,85.89505159902272,27762,23216
139,Ichalkaranji U.A.,1971,18.13,87731,36753,72.09580603397544,47689,40042
139,Ichalkaranji U.A.,1981,32.8,164026,76295,86.96469890916552,88480,75546
139,Ichalkaranji U.A.,1991,38.31,235979,71953,43.86682599100143,124769,111210
139,Ichalkaranji U.A.,2001,38.31,285860,49881,21.137897863792965,150977,134883
139,Ichalkaranji U.A.,2011,38.31,325499,39639,13.86657804519695,169110,156389
140,Shimoga,1961,5.96,63764,17240,37.05614306594447,34024,29740
140,Shimoga,1971,5.96,102709,38945,61.07678313782071,54622,48087
140,Shimoga,1981,16.26,151783,49074,47.779649300450785,79430,72353
140,Shimoga,1991,32.19,193028,41245,27.173662399609967,100442,92586
140,Shimoga,2001,76.71,274352,81324,42.13067534243737,140224,134128
140,Shimoga,2011,76.71,322650,48298,17.604391438735647,162018,160632
141,Chandrapur,1961,28.54,51484,10740,26.35970940506578,27042,24442
141,Chandrapur,1971,28.54,75134,23650,45.93660166265248,39440,35694
141,Chandrapur,1981,28.54,115777,40643,54.09401868661325,60749,55028
141,Chandrapur,1991,56.28,226105,110328,95.29353844027743,119407,106698
141,Chandrapur,2001,56.35,289450,63345,28.015744897282236,151202,138248
141,Chandrapur,2011,56.35,320379,30929,10.685437899464501,164085,156294
142,Junagadh,1961,13.47,74298,11568,18.440937350549977,38885,35413
142,Junagadh,1971,13.47,95900,21602,29.07480685886565,50626,45274
142,Junagadh,1981,13.47,120416,24516,25.56412930135558,62122,58294
142,Junagadh,1991,17.09,167110,46694,38.77723890512888,85726,81384
142,Junagadh,2001,28.13,252108,84998,50.863503081802406,130461,121647
142,Junagadh,2011,57.16,319462,67354,26.716327922953653,163413,156049
143,English Bazar U.A.,1961,7.87,50785,15624,44.44,27110,23675
143,English Bazar U.A.,1971,7.87,68026,17241,33.95,35876,32150
143,English Bazar U.A.,1981,10.26,93244,25218,37.07,48398,44846
143,English Bazar U.A.,1991,20.76,186537,93293,100.05,96958,89579
143,English Bazar U.A.,2001,22.63,224415,37878,20.31,115356,109059
143,English Bazar U.A.,2011,28.41,313681,89266,39.78,166756,146925
144,Purnia U.A.,1961,54.65,53653,28593,114.09816440542697,30689,22964
144,Purnia U.A.,1971,59.7,71311,17658,32.91148677613554,39840,31471
144,Purnia U.A.,1981,60.26,109875,38564,54.07861339765253,60358,49517
144,Purnia U.A.,1991,60.26,136918,27043,24.612514220705346,74009,62909
144,Purnia U.A.,2001,60.26,197211,60293,44.035846272951694,106313,90898
144,Purnia U.A.,2011,108.03,312669,115458,58.54541582366095,164031,148638
145,Nizamabad,1961,36.86,79093,23898,43.297400126823085,41350,37743
145,Nizamabad,1971,36.86,115640,36547,46.20762899371626,59723,55917
145,Nizamabad,1981,36.86,183061,67421,58.30249048772052,94187,88874
145,Nizamabad,1991,36.86,241034,57973,31.668678746428785,122246,118788
145,Nizamabad,2001,30.5,288722,47688,19.78476065617299,146198,142524
145,Nizamabad,2011,30.5,311152,22430,7.768718698263381,154929,156223
146,Hardwar U.A.,1961,13.21,59960,2622,4.57,33821,26139
146,Hardwar U.A.,1971,42.01,91371,31411,52.39,51856,39515
146,Hardwar U.A.,1981,42.01,145946,54575,59.73,80302,65644
146,Hardwar U.A.,1991,42.01,187392,41446,28.4,101834,85558
146,Hardwar U.A.,2001,45.17,220767,33375,17.81,119234,101533
146,Hardwar U.A.,2011,60.68,310796,90029,40.78009847486263,165703,145093
147,Darbhanga U.A.,1961,19.43,103016,18200,21.458215431050746,55096,47920
147,Darbhanga U.A.,1971,19.18,132059,29043,28.192707928865417,71519,60540
147,Darbhanga U.A.,1981,19.18,176301,44242,33.50169242535534,94187,82114
147,Darbhanga U.A.,1991,19.18,218391,42090,23.87394285908758,116915,101476
147,Darbhanga U.A.,2001,19.18,267348,48957,22.41713257414454,142377,124971
147,Darbhanga U.A.,2011,21.51,308011,40663,15.209764052844982,162003,146008
148,Parbhani,1961,46.57,36795,3349,10.013155534294086,19401,17394
148,Parbhani,1971,46.57,61570,24775,67.33251800516375,32989,28581
148,Parbhani,1981,46.57,109364,47794,77.62546694818904,57326,52038
148,Parbhani,1991,57.6,190255,80891,73.96492447240408,99344,90911
148,Parbhani,2001,57.6,259329,69074,36.30601035452419,133959,125370
148,Parbhani,2011,57.6,307170,47841,18.447994632301054,156520,150650
149,Hisar U.A.,1961,17.53,60222,24925,70.61506643624104,33849,26373
149,Hisar U.A.,1971,31.34,89437,29215,48.512171631629634,50303,39134
149,Hisar U.A.,1981,41.38,137369,47932,53.59303196663573,76162,61207
149,Hisar U.A.,1991,49.43,181255,43886,31.947528190494218,98425,82830
149,Hisar U.A.,2001,49.43,263186,81931,45.20206339135472,143795,119391
149,Hisar U.A.,2011,49.43,307024,43838,16.656661068597874,166494,140530
150,Baharampur U.A.,1961,16.19,62317,6704,12.054735403592685,33325,28992
150,Baharampur U.A.,1971,18.970000000000002,78909,16592,26.62515846398254,41148,37761
150,Baharampur U.A.,1981,19.450000000000003,102311,23402,29.656946609385493,52006,50305
150,Baharampur U.A.,1991,19.450000000000003,126400,24089,23.54487787236954,64546,61854
150,Baharampur U.A.,2001,22.67,183045,56645,44.81408227848101,93491,89554
150,Baharampur U.A.,2011,62.53239999999999,304487,121442,66.34543418285122,155768,148719
151,Tumkur @,1961,19.43,47277,11278,31.328648018000507,25324,21953
151,Tumkur @,1971,12.95,70476,23199,49.07037248556381,37909,32567
151,Tumkur @,1981,15.32,108670,38194,54.19433566036665,57555,51115
151,Tumkur @,1991,36.71,179877,71207,65.52590411337076,97799,82078
151,Tumkur @,2001,64.27,248929,69052,38.3884543326829,129273,119656
151,Tumkur @,2011,64.27,302143,53214,21.37717983842782,152925,149218
152,Karnal U.A.,1961,9.84,72109,12319,20.60377989630373,38415,33694
152,Karnal U.A.,1971,18.57,92784,20675,28.671871749712242,49575,43209
152,Karnal U.A.,1981,22.1,132107,39323,42.38122952233144,70680,61427
152,Karnal U.A.,1991,23.6,176131,44024,33.32450210813961,93042,83089
152,Karnal U.A.,2001,25.1,221236,45105,25.608779828650263,117875,103361
152,Karnal U.A.,2011,29.46,302140,80904,36.569093637563505,159653,142487
153,Habra U.A.,1961,24.76,64716,NA,NA,33185,31531
153,Habra U.A.,1971,20.14,93351,28635,44.25,48043,45308
153,Habra U.A.,1981,25.08,129610,36259,38.84,66082,63528
153,Habra U.A.,1991,36.88,196970,67360,51.97,100627,96343
153,Habra U.A.,2001,44.18,254685,57715,29.3,129535,125150
153,Habra U.A.,2011,47.53,299782,45097,17.71,151586,148196
154,Kharagpur U.A.,1961,33.38,147253,17617,13.59,81352,65901
154,Kharagpur U.A.,1971,33.38,161257,14004,9.51,87124,74133
154,Kharagpur U.A.,1981,123.02,232575,71318,44.23,123176,109399
154,Kharagpur U.A.,1991,125.19,264842,32267,13.87,138929,125913
154,Kharagpur U.A.,2001,123.02,272865,8023,3.03,140730,132135
154,Kharagpur U.A.,2011,125.19,299683,26818,9.83,153143,146540
155,Karimnagar U.A.,1961,10.62,31554,7728,32.435154872828,17094,14460
155,Karimnagar U.A.,1971,10.62,48918,17364,55.02947328389428,25735,23183
155,Karimnagar U.A.,1981,10.62,86125,37207,76.05993703749131,45461,40664
155,Karimnagar U.A.,1991,23.82,148583,62458,72.52017416545719,76736,71847
155,Karimnagar U.A.,2001,39.43,218302,69719,46.922595451700396,111875,106427
155,Karimnagar U.A.,2011,54.65,297447,79145,36.25482130259915,149937,147510
156,Biharsharif,1961,19.43,78581,15457,24.486724542170965,40651,37930
156,Biharsharif,1971,19.34,100046,21465,27.315763352464334,53266,46780
156,Biharsharif,1981,19.34,151343,51297,51.27341422945445,79916,71427
156,Biharsharif,1991,23.5,201323,49980,33.02432223492332,106905,94418
156,Biharsharif,2001,23.5,232071,30748,15.272969308027399,122019,110052
156,Biharsharif,2011,23.5,297268,65197,28.093557575052465,155216,142052
157,Palakkad U.A.,1961,26.6,77620,8116,11.677025782688766,38813,38807
157,Palakkad U.A.,1971,30.590000000000003,102820,25200,32.46585931460964,51372,51448
157,Palakkad U.A.,1981,30.590000000000003,117986,15166,14.750048628671465,58595,59391
157,Palakkad U.A.,1991,59.05,180033,62047,52.58844269659112,88907,91126
157,Palakkad U.A.,2001,45.019999999999996,197369,17336,9.629345731060416,96928,100441
157,Palakkad U.A.,2011,123.32,293533,96164,48.72295041267879,143676,149857
158,Aizawl,1961,12.95,14257,7307,105.13669064748201,7630,6627
158,Aizawl,1971,18.39,31740,17483,122.62748123728696,16245,15495
158,Aizawl,1981,110,74493,42753,134.69754253308128,39305,35188
158,Aizawl,1991,110,155240,80747,108.39541970386479,80615,74625
158,Aizawl,2001,128.98,228280,73040,47.049729451172375,115986,112294
158,Aizawl,2011,129,293416,65136,28.533380059575958,144913,148503
159,Sonipar  U.A.,1961,4.38,45882,15693,51.98251018582928,25119,20763
159,Sonipar  U.A.,1971,21.37,62393,16511,35.985789634279236,33750,28643
159,Sonipar  U.A.,1981,21.37,109369,46976,75.29049733143141,59300,50069
159,Sonipar  U.A.,1991,28.32,143922,34553,31.59304739002825,76899,67023
159,Sonipar  U.A.,2001,47.75,225074,81152,56.38609802531928,122480,102594
159,Sonipar  U.A.,2011,43.81,293025,67951,30.19051511947182,156463,136562
160,Dindigul U.A.,1961,14.01,92947,14586,18.613851278059236,47304,45643
160,Dindigul U.A.,1971,11.77,128429,35482,38.174443500059176,65319,63110
160,Dindigul U.A.,1981,14.01,164103,35674,27.77721542642238,83762,80341
160,Dindigul U.A.,1991,14.01,182477,18374,11.196626508960836,92807,89670
160,Dindigul U.A.,2001,35.06,216523,34046,18.657693846347758,109021,107502
160,Dindigul U.A.,2011,66.93,292512,75989,35.09511691598583,145703,146809
161,Farrukhabad-cum-Fatehgarh,1961,14.79,94591,14259,17.75,51490,43101
161,Farrukhabad-cum-Fatehgarh,1971,14.94,110835,16244,17.17,60427,50408
161,Farrukhabad-cum-Fatehgarh,1981,21.09,160796,49961,45.08,88288,72508
161,Farrukhabad-cum-Fatehgarh,1991,21.33,208727,47931,29.81,112011,96716
161,Farrukhabad-cum-Fatehgarh,2001,23.4,242997,34270,16.42,129643,113354
161,Farrukhabad-cum-Fatehgarh,2011,23.4,291374,48377,19.908476236332138,154776,136598
162,Thanjavur U.A.,1961,23.52,111099,10419,10.348629320619786,56135,54964
162,Thanjavur U.A.,1971,24.29,140547,29448,26.506089163718844,71192,69355
162,Thanjavur U.A.,1981,29.15,184015,43468,30.927732359993453,94495,89520
162,Thanjavur U.A.,1991,15.36,202013,17998,9.780724397467598,102193,99820
162,Thanjavur U.A.,2001,74.31,248293,46280,22.909416720706094,123052,125241
162,Thanjavur U.A.,2011,96.60000000000001,291067,42774,17.227227509434417,142671,148396
163,Santipur U.A.,1961,30.01,67212,24799,58.47028033857544,34171,33041
163,Santipur U.A.,1971,30.01,78897,11685,17.385288341367612,40423,38474
163,Santipur U.A.,1981,61.45,135465,56568,71.69854367086201,69048,66417
163,Santipur U.A.,1991,61.45,182149,46684,34.462038164839626,93250,88899
163,Santipur U.A.,2001,55.17000000000001,225060,42911,23.558185880789903,114764,110296
163,Santipur U.A.,2011,59.19570000000001,290345,65285,29.0078201368524,148123,142222
164,Dewas 28,1961,11.53,34577,6698,24.03,18232,16345
164,Dewas 28,1971,14.68,51866,17289,50,27312,24554
164,Dewas 28,1981,17.36,83465,31599,60.92,44264,39201
164,Dewas 28,1991,100.22,164364,80899,96.93,86955,77409
164,Dewas 28,2001,100.22,231672,67308,40.95,121075,110597
164,Dewas 28,2011,100.22,289550,57878,24.982734210435442,150081,139469
165,Anand U.A.,1961,23.490000000000002,47240,10455,28.421911105070002,27507,19733
165,Anand U.A.,1971,23.43,74664,27424,58.052497883149876,42152,32512
165,Anand U.A.,1981,24.64,104032,29368,39.333547626700955,55697,48335
165,Anand U.A.,1991,NA,174480,70448,67.71762534604737,91570,82910
165,Anand U.A.,2001,60.26,218486,44006,25.221228794131136,115295,103191
165,Anand U.A.,2011,75.7,288095,69609,31.859707258130953,148990,139105
166,Bathinda,1961,20.72,52253,17262,49.33268554771226,28971,23282
166,Bathinda,1971,20.72,65318,13065,25.003349090004413,35725,29593
166,Bathinda,1981,82.88,127363,62045,94.9891301019627,70026,57337
166,Bathinda,1991,97,159042,31679,24.87300079300896,85286,73756
166,Bathinda,2001,110,217256,58214,36.60290992316495,116946,100310
166,Bathinda,2011,68.5,285788,68532,31.54,151524,134264
167,Jalna,1961,51.98,67158,8680,14.843188891548959,34874,32284
167,Jalna,1971,25.9,91099,23941,35.64876857559784,47521,43578
167,Jalna,1981,25.9,122276,31177,34.22320771907486,62828,59448
167,Jalna,1991,81.64,174985,52709,43.10657855997906,90600,84385
167,Jalna,2001,81.64,235795,60810,34.75155013286853,121922,113873
167,Jalna,2011,81.64,285577,49782,21.112406963676076,147092,138485
168,Satna U.A.,1961,17.64,38046,17863,88.51,21261,16785
168,Satna U.A.,1971,36.24,62162,24116,63.39,34590,27572
168,Satna U.A.,1981,21.09,96667,34505,55.51,53516,43151
168,Satna U.A.,1991,86.77,160500,63833,66.03,86744,73756
168,Satna U.A.,2001,79.01,229307,68807,42.87,122401,106906
168,Satna U.A.,2011,79.01,282977,53670,23.405303806687105,149415,133562
169,Navsari U.A.,1961,NA,63190,18527,41.48176342834113,32486,30704
169,Navsari U.A.,1971,18.07,80101,16911,26.762145909162843,41943,38158
169,Navsari U.A.,1981,21.75,129266,49165,61.378759316363094,69786,59480
169,Navsari U.A.,1991,NA,190946,61680,47.71556325715965,101587,89359
169,Navsari U.A.,2001,30.87,232411,41465,21.71556356247316,122282,110129
169,Navsari U.A.,2011,32.88,282791,50380,21.67711511073056,148605,134186
170,Maunath Bhanjan,1961,7.77,48785,13978,40.16,25671,23114
170,Maunath Bhanjan,1971,7.77,64058,15273,31.31,34071,29987
170,Maunath Bhanjan,1981,9.11,86326,22268,34.76,45368,40958
170,Maunath Bhanjan,1991,9.11,136697,50371,58.35,70819,65878
170,Maunath Bhanjan,2001,25.61,212657,75960,55.57,109958,102699
170,Maunath Bhanjan,2011,39,278745,66088,31.077274672359717,142967,135778
171,Ratlam U.A.,1961,12.95,87472,24069,37.96,46391,41081
171,Ratlam U.A.,1971,15.53,119247,31775,36.33,62646,56601
171,Ratlam U.A.,1981,40.87,155578,36331,30.47,81161,74417
171,Ratlam U.A.,1991,40.87,195776,40198,25.84,101855,93921
171,Ratlam U.A.,2001,40.87,234419,38643,19.74,120874,113545
171,Ratlam U.A.,2011,41.37,273998,39579,16.88387033474249,139665,134333
172,Sambalpur   U.A.,1961,44.81,57738,34213,145.43,32427,25311
172,Sambalpur   U.A.,1971,76.69,105085,47347,82,57496,47589
172,Sambalpur   U.A.,1981,89.5,162214,57129,54.36,86280,75934
172,Sambalpur   U.A.,1991,89.5,193297,31083,19.16,102556,90741
172,Sambalpur   U.A.,2001,89.5,226469,33172,17.16,117745,108724
172,Sambalpur   U.A.,2011,89.5,266271,39802,17.575032344382674,136827,129444
173,Ranipet U.A.$,1961,32.35,75623,9493,14.355058218660217,37930,37693
173,Ranipet U.A.$,1971,27.12,92411,16788,22.199595361199634,46636,45775
173,Ranipet U.A.$,1981,27.32,114854,22443,24.286069840170544,58059,56795
173,Ranipet U.A.$,1991,27.63,141373,26519,23.089313389172343,70241,71132
173,Ranipet U.A.$,2001,49.9,191329,49956,35.33630891330027,95186,96143
173,Ranipet U.A.$,2011,85.32,264330,73001,38.15469688337889,130753,133577
174,Hapur,1961,5.83,55248,5988,12.16,29908,25340
174,Hapur,1971,5.83,71266,16018,28.99,38255,33011
174,Hapur,1981,5.83,102837,31571,44.3,55068,47769
174,Hapur,1991,14.2,146262,43425,42.23,78324,67938
174,Hapur,2001,14.2,211983,65721,44.93,113175,98808
174,Hapur,2011,14.2,262983,51000,24.0585329955704,139525,123458
175,Khammam U.A.,1961,8.68,35888,7637,27.032671409861596,18768,17120
175,Khammam U.A.,1971,8.68,56919,21031,58.60176103432902,29400,27519
175,Khammam U.A.,1981,18.53,98757,41838,73.50445369735941,51111,47646
175,Khammam U.A.,1991,25.52,149077,50320,50.95335014226839,76313,72764
175,Khammam U.A.,2001,25.52,198620,49543,33.23316138639763,100930,97690
175,Khammam U.A.,2011,39.82,262255,63635,32.038566106132315,129753,132502
176,Arrah,1961,28.72,76766,12561,19.56389689276536,41748,35018
176,Arrah,1971,30.97,92919,16153,21.041867493421567,50631,42288
176,Arrah,1981,30.97,125111,32192,34.64522863999828,67488,57623
176,Arrah,1991,30.97,157082,31971,25.554107952138498,84740,72342
176,Arrah,2001,30.97,203380,46298,29.473778026763092,109867,93513
176,Arrah,2011,30.97,261430,58050,28.542629560428757,138804,122626
177,Etawah,1961,9.35,69681,9695,16.16,38070,31611
177,Etawah,1971,9.35,85894,16213,23.27,46381,39513
177,Etawah,1981,9.35,112174,26280,30.6,59798,52376
177,Etawah,1991,9.35,124072,11898,10.61,65981,58091
177,Etawah,2001,40.94,210453,86381,69.62,111749,98704
177,Etawah,2011,28.94,256838,46385,22.040550621754026,135439,121399
178,Faizabad U.A.,1961,51.18,88296,5798,7.03,48889,39407
178,Faizabad U.A.,1971,51.17,109806,21510,24.36,62003,47803
178,Faizabad U.A.,1981,63.39,143167,33361,30.38,80952,62215
178,Faizabad U.A.,1991,63.39,176922,33755,23.58,98351,78571
178,Faizabad U.A.,2001,63.39,208162,31240,17.66,114330,93832
178,Faizabad U.A.,2011,51.94,256624,48462,23.280906217273085,137138,119486
179,Wadhwan U.A.,1961,23.28,75706,18071,31.3542118504381,39151,36555
179,Wadhwan U.A.,1971,32.6,97251,21545,28.458774733838798,49922,47329
179,Wadhwan U.A.,1981,32.6,130602,33351,34.293734768794145,67357,63245
179,Wadhwan U.A.,1991,32.6,166466,35864,27.460528935238358,86288,80178
179,Wadhwan U.A.,2001,58.6,219585,53119,31.90981942258479,114175,105410
179,Wadhwan U.A.,2011,58.60000000000001,253606,34021,15.493316938770862,132114,121492
180,Bharatpur U.A.,1961,28.88,49776,12455,33.37263203022427,27805,21971
180,Bharatpur U.A.,1971,23.42,69902,20126,40.43314046930247,38470,31432
180,Bharatpur U.A.,1981,34.83,105274,35372,50.6022717518812,57400,47874
180,Bharatpur U.A.,1991,51.41,156880,51606,49.02065087296009,84864,72016
180,Bharatpur U.A.,2001,56.95,205235,48355,30.822921978582357,110397,94838
180,Bharatpur U.A.,2011,60.07,252838,47603,23.194386922308574,134040,118798
181,Ramagundam U.A.,1971,28.47,31928,NA,NA,16795,15133
181,Ramagundam U.A.,1981,28.47,82908,50980,159.6717614632924,42612,40296
181,Ramagundam U.A.,1991,28.47,214384,131476,158.58059535871087,109865,104519
181,Ramagundam U.A.,2001,117.5,248696,34312,16.004925740726918,126884,121812
181,Ramagundam U.A.,2011,169.57,252308,3612,1.4523755910830893,128239,124069
182,Begusarai #,1961,7.56,27346,12205,80.60894260616868,14507,12839
182,Begusarai #,1971,9.61,44084,16738,61.20822058070651,23802,20282
182,Begusarai #,1981,10.25,68305,24221,54.9428364032302,36777,31528
182,Begusarai #,1991,11.52,84018,15713,23.004172461752432,45604,38414
182,Begusarai #,2001,11.51,107623,23605,28.095170082601346,57541,50082
182,Begusarai #,2011,47.51,252008,144385,134.1581260511229,133722,118286
183,Morvi U.A.,1961,9.71,50192,9470,23.255242866263938,25943,24249
183,Morvi U.A.,1971,8.62,60976,10784,21.48549569652534,31863,29113
183,Morvi U.A.,1981,8.62,73327,12351,20.255510364733667,37828,35499
183,Morvi U.A.,1991,NA,120117,46790,63.810056323046084,62123,57994
183,Morvi U.A.,2001,NA,178055,57938,48.23463789471932,92639,85416
183,Morvi U.A.,2011,66.5,251859,73804,41.45,131188,120671
184,Eluru U.A.,1961,12.02,108321,21108,24.20281380069485,54049,54272
184,Eluru U.A.,1971,14.38,127023,18702,17.265350209100728,63186,63837
184,Eluru U.A.,1981,14.55,168154,41131,32.38074994292372,83805,84349
184,Eluru U.A.,1991,14.55,212866,44712,26.58991162862614,105975,106891
184,Eluru U.A.,2001,22.19,215804,2938,1.3802110247761503,105476,110328
184,Eluru U.A.,2011,23.85,250834,35030,16.232321921743807,123785,127049
185,Ganganagar U.A.,1961,6.09,63854,27417,75.24494332683811,36393,27461
185,Ganganagar U.A.,1971,6.09,90042,26188,41.01230933066057,50405,39637
185,Ganganagar U.A.,1981,6.09,123692,33650,37.37144887941183,69207,54485
185,Ganganagar U.A.,1991,20.87,161482,37790,30.55169291465899,87669,73813
185,Ganganagar U.A.,2001,26.38,222858,61376,38.007951350614924,121865,100993
185,Ganganagar U.A.,2011,36.67,249914,27056,12.140466126412335,134395,115519
186,Dankuni U.A.,1981,8.24,24138,NA,NA,12744,11394
186,Dankuni U.A.,1991,11.74,51792,27654,114.56624409644544,26993,24799
186,Dankuni U.A.,2001,18.259999999999998,90437,38645,74.61577077540933,46557,43880
186,Dankuni U.A.,2011,64.29180000000001,249015,158578,175.34637371872134,127099,121916
187,Gandhidham,1961,NA,26514,21422,420.69913589945014,14334,12180
187,Gandhidham,1971,12.98,38908,12394,46.745115787885645,20730,18178
187,Gandhidham,1981,12.98,61489,22581,58.03690757684795,32590,28899
187,Gandhidham,1991,29.58,104585,43096,70.08733269365253,54870,49715
187,Gandhidham,2001,29.58,151693,47108,45.04278816273844,79379,72314
187,Gandhidham,2011,29.58,247992,96299,63.48282386135155,131484,116508
188,Mirzapur-cum-Vindhyachal U.A.,1961,38.85,100097,13569,15.68,52883,47214
188,Mirzapur-cum-Vindhyachal U.A.,1971,38.85,105939,5842,5.84,57166,48773
188,Mirzapur-cum-Vindhyachal U.A.,1981,38.85,127787,21848,20.62,68879,58908
188,Mirzapur-cum-Vindhyachal U.A.,1991,38.85,169336,41549,32.51,90836,78500
188,Mirzapur-cum-Vindhyachal U.A.,2001,40.68,210763,41427,24.464378513724196,112726,98037
188,Mirzapur-cum-Vindhyachal U.A.,2011,42.09,246920,36157,17.155288167277938,132055,114865
189,Sikar U.A.,1961,24.71,50636,6496,14.716810149524239,26035,24601
189,Sikar U.A.,1971,24.71,70987,20351,40.190773362824864,36912,34075
189,Sikar U.A.,1981,19.5,102970,31983,45.0547283305394,53770,49200
189,Sikar U.A.,1991,22.57,148272,45302,43.99533844809167,77668,70604
189,Sikar U.A.,2001,24.67,185925,37653,25.394545160246036,96697,89228
189,Sikar U.A.,2011,47.18,244497,58572,31.503025413473175,126837,117660
190,Alappuzha U.A.,1961,46.78,138834,22556,19.398338464713873,69977,68857
190,Alappuzha U.A.,1971,46.77,160166,21332,15.365112292377948,80307,79859
190,Alappuzha U.A.,1981,46.77,169940,9774,6.102418740556673,84012,85928
190,Alappuzha U.A.,1991,70.48,227716,57776,33.997881605272454,111520,116196
190,Alappuzha U.A.,2001,65.57,239384,11668,5.123926294155878,116217,123167
190,Alappuzha U.A.,2011,65.57000000000001,240991,1607,0.6713063529726297,116439,124552
191,Katihar U.A.,1961,10.9,59344,16979,40.07789448837484,34623,24721
191,Katihar U.A.,1971,16.56,80121,20777,35.01112159611755,45214,34907
191,Katihar U.A.,1981,24.54,122005,41884,52.27593265186405,67753,54252
191,Katihar U.A.,1991,24.54,154367,32362,26.525142412196224,83977,70390
191,Katihar U.A.,2001,24.54,190873,36506,23.648836862800987,102161,88712
191,Katihar U.A.,2011,51.7,240838,49965,26.17709157397851,127240,113598
192,Vizianagaram U.A.,1961,8.81,76808,9704,14.461134954697187,38806,38002
192,Vizianagaram U.A.,1971,19.31,99004,22196,28.898031455056767,49799,49205
192,Vizianagaram U.A.,1981,19.31,129170,30166,30.46947598076845,64890,64280
192,Vizianagaram U.A.,1991,30.42,177022,47852,37.04575365797012,88047,88975
192,Vizianagaram U.A.,2001,31.09,195801,18779,10.608285975754427,97032,98769
192,Vizianagaram U.A.,2011,39.45,239909,44108,22.526953386346342,117795,122114
193,Dhulian U.A.,1961,7.77,17220,1285,8.064010040790711,8859,8361
193,Dhulian U.A.,1971,7.77,22068,4848,28.153310104529616,11203,10865
193,Dhulian U.A.,1981,7.77,25466,3398,15.397861156425593,12710,12756
193,Dhulian U.A.,1991,12.23,50252,24786,97.32977303070761,25182,25070
193,Dhulian U.A.,2001,23.449999999999996,138931,88679,176.46859826474568,69601,69330
193,Dhulian U.A.,2011,26.757999999999996,239019,100088,72.04151701204195,119096,119923
194,Roorkee U.A.,1961,16.19,45801,12709,38.40505258068415,29154,16647
194,Roorkee U.A.,1971,17.04,62456,16655,36.363834850767454,38054,24402
194,Roorkee U.A.,1981,17.86,87153,24697,39.54303829896247,51839,35314
194,Roorkee U.A.,1991,17.86,103334,16181,18.566199671841474,56364,46970
194,Roorkee U.A.,2001,25.35,155298,51964,50.28741750053225,85357,69941
194,Roorkee U.A.,2011,33.86,238422,83124,53.525480044817066,129802,108620
195,Ottappalam U.A.,1961,32.09,32858,-1433,-4.178939080225132,16145,16713
195,Ottappalam U.A.,1971,47.47,57272,24414,74.30153995982714,28109,29163
195,Ottappalam U.A.,1981,49.260000000000005,58276,1004,1.7530381338175722,28101,30175
195,Ottappalam U.A.,1991,64.94,83736,25460,43.6886539913515,39834,43902
195,Ottappalam U.A.,2001,64.94,91271,7535,8.99851915544091,43196,48075
195,Ottappalam U.A.,2011,174.23,237970,146699,160.72903770091267,114079,123891
196,Rewa,1961,12.2,43065,13442,45.38,24404,18661
196,Rewa,1971,52.57,69182,26117,60.65,38135,31047
196,Rewa,1981,52.57,100641,31459,45.47,56271,44370
196,Rewa,1991,54.99,128981,28340,28.16,70735,58246
196,Rewa,2001,54.99,183274,54293,42.09,98793,84481
196,Rewa,2011,102,235654,52380,28.580158669533052,124012,111642
197,Bulandshahar U.A.,1961,3.24,44163,6667,17.78,24125,20038
197,Bulandshahar U.A.,1971,3.29,59505,15342,34.74,32165,27340
197,Bulandshahar U.A.,1981,9.39,103436,43931,73.83,55346,48090
197,Bulandshahar U.A.,1991,12.33,127201,23765,22.98,67431,59770
197,Bulandshahar U.A.,2001,12.22,176425,49224,38.7,93531,82894
197,Bulandshahar U.A.,2011,39.41,234945,58520,33.16990222474139,122838,112107
198,Sivakasi U.A.  $,1961,7.51,30690,8016,35.35326806033342,15442,15248
198,Sivakasi U.A.  $,1971,13.07,60753,30063,97.95698924731184,30797,29956
198,Sivakasi U.A.  $,1981,31.11,113638,52885,87.0491992164996,57242,56396
198,Sivakasi U.A.  $,1991,34.27,163082,49444,43.51009345465425,81963,81119
198,Sivakasi U.A.  $,2001,53.43,201009,37927,23.25639862155235,100430,100579
198,Sivakasi U.A.  $,2011,124.05,234704,33695,16.762931013039218,116887,117817
199,Ranaghat U.A.,1961,13.24,42889,10932,34.21,22749,20140
199,Ranaghat U.A.,1971,13.24,58375,15486,36.11,30468,27907
199,Ranaghat U.A.,1981,23.6,98325,39950,68.44,50311,48014
199,Ranaghat U.A.,1991,27.72,124695,26370,26.82,63839,60856
199,Ranaghat U.A.,2001,34.37,173587,48892,39.21,88490,85097
199,Ranaghat U.A.,2011,48.46,234499,60912,35.09,118970,115529
200,Karur U.A.,1961,6.03,50564,8409,19.947811647491402,25630,24934
200,Karur U.A.,1971,6.03,65706,15142,29.946206787437703,33615,32091
200,Karur U.A.,1981,11.190000000000001,93810,28104,42.77234955711807,47958,45852
200,Karur U.A.,1991,19.03,113669,19859,21.16938492698007,57932,55737
200,Karur U.A.,2001,32.96,153365,39696,34.9224502722818,77207,76158
200,Karur U.A.,2011,53.34,234191,80826,52.70172464382355,116737,117454
201,Raichur $,1961,52.58,63329,9297,17.206470239857865,32482,30847
201,Raichur $,1971,22,79831,16502,26.05757236021411,41491,38340
201,Raichur $,1981,28.43,124762,44931,56.2826470919818,64529,60233
201,Raichur $,1991,75.24,170577,45815,36.72191853288663,87806,82771
201,Raichur $,2001,43.85,207421,36844,21.599629492839,105763,101658
201,Raichur $,2011,43.85,234073,26652,12.849229345148274,117657,116416
202,Udhagamandalam U.A. $,1961,74.54,103132,27146,35.72500197404785,54520,48612
202,Udhagamandalam U.A. $,1971,81.51,132799,29667,28.766047395570727,69697,63102
202,Udhagamandalam U.A. $,1981,81.49,168574,35775,26.939208879584935,88875,79699
202,Udhagamandalam U.A. $,1991,79.01,179732,11158,6.6190515737895526,91624,88108
202,Udhagamandalam U.A. $,2001,253.1,253068,73336,40.80297331582579,126450,126618
202,Udhagamandalam U.A. $,2011,134.11,233426,-19642,-7.761550255267359,115218,118208
203,Kathgodam U.A.,1961,10.62,38032,12967,51.73,21796,16236
203,Kathgodam U.A.,1971,10.62,52205,14173,37.27,29486,22719
203,Kathgodam U.A.,1981,10.62,77300,25095,48.07,42472,34828
203,Kathgodam U.A.,1991,10.62,104195,26895,34.79,56550,47645
203,Kathgodam U.A.,2001,17.93,158896,54701,52.5,84541,74355
203,Kathgodam U.A.,2011,49.57,232095,73199,46.06723894874635,121409,110686
204,Pali,1961,92.49,33303,9203,38.18672199170125,17932,15371
204,Pali,1971,12.95,49834,16531,49.63817073536919,27216,22618
204,Pali,1981,12.95,91568,41734,83.7460368423165,49921,41647
204,Pali,1991,83.97,136842,45274,49.44303686877512,73681,63161
204,Pali,2001,159,187641,50799,37.12237470951901,99267,88374
204,Pali,2011,159,230075,42434,22.614460592301256,119924,110151
205,Hosur U.A.,1961,5.83,11683,2971,34.10238751147842,6046,5637
205,Hosur U.A.,1971,12.62,16591,4908,42.009757767696655,8604,7987
205,Hosur U.A.,1981,12.62,27129,10538,63.51636429389428,14471,12658
205,Hosur U.A.,1991,12.5,41739,14610,53.85380957646798,22355,19384
205,Hosur U.A.,2001,28.8,99651,57912,138.74793358729247,52583,47068
205,Hosur U.A.,2011,59.910000000000004,229528,129877,130.33185818506587,117994,111534
206,Kanhangad U.A.,1961,32.27,23621,4316,22.356902356902356,11713,11908
206,Kanhangad U.A.,1971,32.34,31869,8248,34.918081368273995,15971,15898
206,Kanhangad U.A.,1981,NA,NA,NA,NA,NA,NA
206,Kanhangad U.A.,1991,51.63,71049,NA,NA,34637,36412
206,Kanhangad U.A.,2001,84.08,129367,58318,82.08138045574181,62002,67365
206,Kanhangad U.A.,2011,135.78,229168,99801,77.14563992362812,106569,122599
207,Silchar U.A.,1961,9.06,41062,7003,20.56137878387504,22833,18229
207,Silchar U.A.,1971,10,52596,11534,28.08923091909795,28400,24196
207,Silchar U.A.,1981,NA,NA,NA,NA,NA,NA
207,Silchar U.A.,1991,15.75,115483,NA,NA,60156,55327
207,Silchar U.A.,2001,30.38,184105,68622,59.421733068936554,94306,89799
207,Silchar U.A.,2011,30.39,229136,45031,24.459411748730346,115497,113639
208,Nadiad U.A.,1961,28.28,78952,16307,26.030808524223804,41893,37059
208,Nadiad U.A.,1971,28.58,108269,29317,37.13268821562468,57331,50938
208,Nadiad U.A.,1981,28.48,142689,34420,31.79118676629506,74276,68413
208,Nadiad U.A.,1991,NA,170217,27528,19.292307045392427,87914,82303
208,Nadiad U.A.,2001,29.54,196793,26576,15.613011626335796,102336,94457
208,Nadiad U.A.,2011,29.54,225071,28278,14.369413546213533,115903,109168
209,Nagercoil,1961,21.75,106207,26923,33.95767115685384,53359,52848
209,Nagercoil,1971,24.29,141288,35081,33.03077951547449,70870,70418
209,Nagercoil,1981,24.27,171648,30360,21.488024460676066,85872,85776
209,Nagercoil,1991,24.27,190084,18436,10.74058538404176,94834,95250
209,Nagercoil,2001,24.27,208179,18095,9.519475600260938,102907,105272
209,Nagercoil,2011,24.27,224849,16670,8.007531979690555,109938,114911
210,Bharuch U.A.,1961,8.03,73639,10910,17.392274705479124,37927,35712
210,Bharuch U.A.,1971,8.02,92251,18612,25.274650660655357,47978,44273
210,Bharuch U.A.,1981,8.02,112524,20273,21.975913540232625,58566,53958
210,Bharuch U.A.,1991,NA,139029,26505,23.55497493867975,71717,67312
210,Bharuch U.A.,2001,20.08,176364,37335,26.854109574261486,91281,85083
210,Bharuch U.A.,2011,27.77,223647,47283,26.80989317547799,115251,108396
211,Murwara (Katni) 30,1961,33.77,60472,26588,78.47,32085,28387
211,Murwara (Katni) 30,1971,88.57,86535,26063,43.1,45946,40589
211,Murwara (Katni) 30,1981,80.42,123017,36482,42.16,64991,58026
211,Murwara (Katni) 30,1991,107.1,163431,40414,32.85,85758,77673
211,Murwara (Katni) 30,2001,68.57,187029,23598,14.44,97843,89186
211,Murwara (Katni) 30,2011,68.57,221883,34854,18.635612658999406,115348,106535
212,Kancheepuram U.A.,1961,11.65,92714,7904,9.31965570097866,46624,46090
212,Kancheepuram U.A.,1971,35.95,118464,25750,27.773583277606402,60414,58050
212,Kancheepuram U.A.,1981,36.269999999999996,142894,24430,20.622298757428418,72296,70598
212,Kancheepuram U.A.,1991,36.18,168311,25417,17.787310873794564,84933,83378
212,Kancheepuram U.A.,2001,27.37,188733,20422,12.133490978010943,95068,93665
212,Kancheepuram U.A.,2011,27.37,221715,32982,17.475481235396035,110749,110966
213,Sambhal $,1961,6.22,68940,7511,12.23,35800,33140
213,Sambhal $,1971,6.22,86323,17383,25.21,46392,39931
213,Sambhal $,1981,10.65,108232,21909,25.38,57816,50416
213,Sambhal $,1991,15.65,150869,42637,39.39,80623,70246
213,Sambhal $,2001,15.65,182478,31609,20.95,97011,85467
213,Sambhal $,2011,15.65,220813,38335,21.008011924725174,115767,105046
214,Singrauli 31,1991,56.9,60207,NA,NA,34153,26054
214,Singrauli 31,2001,284.46,185190,124983,207.59,100149,85041
214,Singrauli 31,2011,284.46,220257,35067,18.935687672120523,116867,103390
215,Proddatur U.A.,1961,7.12,50616,13992,38.20445609436435,25929,24687
215,Proddatur U.A.,1971,7.12,70822,20206,39.92018334123597,36520,34302
215,Proddatur U.A.,1981,7.12,107070,36248,51.18183615260795,54867,52203
215,Proddatur U.A.,1991,7.12,133914,26844,25.071448585037825,68283,65631
215,Proddatur U.A.,2001,21.06,165216,31302,23.374703167704645,82893,82323
215,Proddatur U.A.,2011,39.54,217786,52570,31.818952159597135,108873,108913
216,Porbandar U.A.,1961,9.92,75081,16257,27.636678906568747,38863,36218
216,Porbandar U.A.,1971,27.67,106727,31646,42.149145589430084,55114,51613
216,Porbandar U.A.,1981,30.06,133307,26580,24.90466329982104,68358,64949
216,Porbandar U.A.,1991,NA,160167,26860,20.148979423436128,81911,78256
216,Porbandar U.A.,2001,NA,197382,37215,23.23512334001386,101824,95558
216,Porbandar U.A.,2011,57.42,217203,19821,10.041949113900964,111934,105269
217,Bidar U.A.,1961,9.06,32420,1079,3.442774640247606,17012,15408
217,Bidar U.A.,1971,13,50670,18250,56.29241209130166,26755,23915
217,Bidar U.A.,1981,11.12,78856,28186,55.62660351292678,41687,37169
217,Bidar U.A.,1991,47.05,132408,53552,67.91112914679923,70200,62208
217,Bidar U.A.,2001,58.09,174257,41849,31.60609630838016,90662,83595
217,Bidar U.A.,2011,58.09,216020,41763,23.9663255995455,111470,104550
218,Chapra U.A.,1961,19.42,75580,11271,17.52631824472469,40884,34696
218,Chapra U.A.,1971,16.96,83101,7521,9.951045250066155,45551,37550
218,Chapra U.A.,1981,16.96,111564,28463,34.2510920446204,60082,51482
218,Chapra U.A.,1991,16.96,136877,25313,22.689218744397834,73934,62943
218,Chapra U.A.,2001,16.96,179190,42313,30.913155606858712,95494,83696
218,Chapra U.A.,2011,19.05,213714,34524,19.26670015067805,112519,101195
219,Munger,1961,17.35,89768,15420,20.74030236186582,47700,42068
219,Munger,1971,17.5,102474,12706,14.154264325817664,55518,46956
219,Munger,1981,17.5,129260,26786,26.139313386810315,69397,59863
219,Munger,1991,17.5,150112,20852,16.131827324771777,80662,69450
219,Munger,2001,17.5,188050,37938,25.27312939671712,101264,86786
219,Munger,2011,17.5,213303,25253,13.428875299122575,113291,100012
220,Nandyal U.A.,1961,14.32,42927,9583,28.739803262955853,21964,20963
220,Nandyal U.A.,1971,12.95,63193,20266,47.21038041325972,32463,30730
220,Nandyal U.A.,1981,15.42,88185,24992,39.54868418970456,44988,43197
220,Nandyal U.A.,1991,15.42,119813,31628,35.865510007370865,61448,58365
220,Nandyal U.A.,2001,15.46,157120,37307,31.137689566240724,79500,77620
220,Nandyal U.A.,2011,28.88,211424,54304,34.562118126272914,105826,105598
221,Panchkula,1981,10.37,11239,NA,NA,6709,4530
221,Panchkula,1991,15.24,70375,59136,526.17,38074,32301
221,Panchkula,2001,25.5,140925,70550,100.25,75897,65028
221,Panchkula,2011,32.6,211355,70430,49.98,111731,99624
222,Burhanpur,1961,11.37,82090,12024,17.16,42410,39680
222,Burhanpur,1971,12.83,105335,23245,28.32,54590,50745
222,Burhanpur,1981,12.67,140986,35651,33.85,72612,68374
222,Burhanpur,1991,12.67,172710,31724,22.5,88511,84199
222,Burhanpur,2001,12.67,193725,21015,12.17,99751,93974
222,Burhanpur,2011,12.67,210886,17161,8.858433346238224,108187,102699
223,Mahbubnagar U.A.,1961,7.77,35588,11761,49.35996978217988,18581,17007
223,Mahbubnagar U.A.,1971,9.91,51756,16168,45.43104417219288,26854,24902
223,Mahbubnagar U.A.,1981,9.91,87503,35747,69.06832058118866,45736,41767
223,Mahbubnagar U.A.,1991,13.7,116833,29330,33.518850782258895,60211,56622
223,Mahbubnagar U.A.,2001,13.7,139662,22829,19.53985603382606,71516,68146
223,Mahbubnagar U.A.,2011,80.16,210258,70596,50.54775099884006,106086,104172
224,Ongole U.A.,1961,5.28,35804,7994,28.745055735346998,18214,17590
224,Ongole U.A.,1971,8.05,53330,17526,48.9498380069266,27235,26095
224,Ongole U.A.,1981,8.1,85302,31972,59.951246952934554,44335,40967
224,Ongole U.A.,1991,19.77,128648,43346,50.81475229185717,66088,62560
224,Ongole U.A.,2001,27.2,153829,25181,19.573565076798708,78242,75587
224,Ongole U.A.,2011,27.2,208344,54515,35.438701415207795,104646,103698
225,Hospet $,1961,26.42,62870,24219,62.66073322811829,32383,30487
225,Hospet $,1971,24.3,76168,13298,21.1515826308255,39379,36789
225,Hospet $,1981,36,115351,39183,51.442863144627665,58757,56594
225,Hospet $,1991,50.92,134799,19448,16.859845168225675,68976,65823
225,Hospet $,2001,49.7,164240,29441,21.84066647378691,83767,80473
225,Hospet $,2011,49.7,206167,41927,25.527886020457856,102668,103499
226,Ambala  U.A.,1961,36.26,105543,11500,12.22844868836596,61103,44440
226,Ambala  U.A.,1971,36.26,102493,-3050,-2.889817420387899,53202,49291
226,Ambala  U.A.,1981,39.72,128545,26052,25.4183212512074,65389,63156
226,Ambala  U.A.,1991,39.72,152639,24094,18.743630635186122,77466,75173
226,Ambala  U.A.,2001,44.26,199539,46900,30.726092283099337,109464,90075
226,Ambala  U.A.,2011,46.13,205418,5879,2.9462912012188096,111475,93943
227,Bhusawal U.A.,1961,28.21,79121,24775,45.5875317410665,41786,37335
227,Bhusawal U.A.,1971,27.25,104708,25587,32.33907559307895,55152,49556
227,Bhusawal U.A.,1981,35.44,132142,27434,26.200481338579667,68934,63208
227,Bhusawal U.A.,1991,24.8,159799,27657,20.929757382210045,83405,76394
227,Bhusawal U.A.,2001,24.8,187564,27765,17.374952283806532,97243,90321
227,Bhusawal U.A.,2011,24.8,203774,16210,8.642383399799535,104717,99057
228,Deoghar %%,1961,31.83,35105,9595,37.61270090160721,19432,15673
228,Deoghar %%,1971,23.86,45060,9955,28.357783791482692,25162,19898
228,Deoghar %%,1981,23.86,59120,14060,31.20284065690191,32509,26611
228,Deoghar %%,1991,24.55,85902,26782,45.301082543978346,47194,38708
228,Deoghar %%,2001,22.26,112525,26623,30.992293543805733,61442,51083
228,Deoghar %%,2011,119.7,203123,90598,80.51366363030438,107997,95126
229,Haldia,1971,21.59,9968,NA,NA,6029,3939
229,Haldia,1981,21.59,21122,11154,111.89807383627607,11852,9270
229,Haldia,1991,69.1,100347,79225,375.0828520026513,54504,45843
229,Haldia,2001,104.9,170673,70326,70.08281264013871,89893,80780
229,Haldia,2011,109.65,200827,30154,17.667703737556614,104841,95986
230,Khandwa,1961,22.56,63505,11565,22.27,33790,29715
230,Khandwa,1971,23.08,85403,21898,34.48,44874,40529
230,Khandwa,1981,22.57,114725,29322,34.33,59866,54859
230,Khandwa,1991,35.77,145133,30408,26.51,75781,69352
230,Khandwa,2001,35.77,172242,27109,18.68,88950,83292
230,Khandwa,2011,35.77,200738,28496,16.544164605613034,102901,97837
231,Puri,1961,16.83,60815,11758,23.97,33626,27189
231,Puri,1971,16.84,72674,11859,19.5,39067,33607
231,Puri,1981,16.84,100942,28268,38.9,53789,47153
231,Puri,1991,16.84,125199,24257,24.03,66508,58691
231,Puri,2001,16.84,157837,32638,26.07,82269,75568
231,Puri,2011,16.84,200564,42727,27.070332051420138,104086,96478
232,Morena,1961,6.73,28337,10213,56.35,15761,12576
232,Morena,1971,12,44901,16564,58.45,24859,20042
232,Morena,1981,12,69864,24963,55.6,38642,31222
232,Morena,1991,96,147124,77260,110.59,81349,65775
232,Morena,2001,12,150959,3835,2.61,82305,68654
232,Morena,2011,12,200482,49523,32.8055962214906,108390,92092
233,Raiganj U.A.,1961,10.64,32290,16817,108.6860983648937,17574,14716
233,Raiganj U.A.,1971,10.64,43191,10901,33.759677918860326,22862,20329
233,Raiganj U.A.,1981,14.540000000000001,66705,23514,54.441897617559206,35019,31686
233,Raiganj U.A.,1991,14.540000000000001,159266,92561,138.76171201559103,85740,73526
233,Raiganj U.A.,2001,16.580000000000002,180160,20894,13.118933105622041,95387,84773
233,Raiganj U.A.,2011,16.7,199690,19530,10.840364120781528,104733,94957
234,Amroha #,1961,6.32,68965,9860,16.68,34861,34104
234,Amroha #,1971,6.32,82702,13737,19.92,43019,39683
234,Amroha #,1981,6.32,112682,29980,36.25,59589,53093
234,Amroha #,1991,6.32,137061,24379,21.64,72202,64859
234,Amroha #,2001,6.32,165129,28068,20.48,86943,78186
234,Amroha #,2011,8.95,198471,33342,20.191486655887214,103097,95374
235,Bhind,1961,5.46,28208,11590,69.74,15937,12271
235,Bhind,1971,5.59,45794,17586,62.34,25571,20223
235,Bhind,1981,17.18,74515,28721,62.72,40938,33577
235,Bhind,1991,17.18,109755,35240,47.29,59728,50027
235,Bhind,2001,17.18,153752,43997,40.09,82945,70807
235,Bhind,2011,17.18,197585,43833,28.508897445236485,105352,92233
236,Hardoi U.A.,1961,6.47,36725,6844,22.9,20688,16037
236,Hardoi U.A.,1971,6.48,46639,9914,27,25861,20778
236,Hardoi U.A.,1981,6.48,67259,20620,44.21,36763,30496
236,Hardoi U.A.,1991,6.48,88651,21392,31.81,47389,41262
236,Hardoi U.A.,2001,6.42,112486,23835,26.89,59876,52610
236,Hardoi U.A.,2011,50.42,197029,84543,75.15868641430934,103619,93410
237,Bhiwani,1961,12.95,58194,6011,11.519077094072783,30982,27212
237,Bhiwani,1971,9.07,73086,14892,25.590267037838956,39957,33129
237,Bhiwani,1981,29.74,101277,28191,38.572366800755276,55172,46105
237,Bhiwani,1991,27.64,121629,20352,20.095381972214817,64977,56652
237,Bhiwani,2001,27.64,169531,47902,39.38369961111248,91697,77834
237,Bhiwani,2011,27.64,196057,26526,15.646695884528494,104026,92031
238,"Navi Mumbai (Panvel, Raigarh)",1991,41.86,42732,NA,NA,23754,18978
238,"Navi Mumbai (Panvel, Raigarh)",2001,41.86,81855,39123,91.55433866891323,46219,35636
238,"Navi Mumbai (Panvel, Raigarh)",2011,41.86,195373,113518,138.68181540528983,107342,88031
239,Ambala,1961,8.7,76204,18225,31.433794994739472,41462,34742
239,Ambala,1971,8.7,83633,7429,9.748832082305391,44469,39164
239,Ambala,1981,16.94,104565,20932,25.028397881219135,55193,49372
239,Ambala,1991,16.94,119338,14773,14.12805432027925,61852,57486
239,Ambala,2001,16.94,139279,19941,16.709681744289327,74016,65263
239,Ambala,2011,34.14,195153,55874,40.11660049253656,102607,92546
240,Kumarapalayam U.A. *,1961,44.03,24757,14865,150.27294783663567,12545,12212
240,Kumarapalayam U.A. *,1971,48.84,44198,19441,78.5272852122632,22773,21425
240,Kumarapalayam U.A. *,1981,18.54,92439,48241,109.1474727363229,48031,44408
240,Kumarapalayam U.A. *,1991,28.9,116740,24301,26.28868767511548,60028,56712
240,Kumarapalayam U.A. *,2001,33.19,132174,15434,13.220832619496317,67481,64693
240,Kumarapalayam U.A. *,2011,70.78,195071,62897,47.586514745713984,98596,96475
241,Fatehpur,1961,3.18,28323,4022,16.55,15299,13024
241,Fatehpur,1971,56.98,54665,26342,93.01,29371,25294
241,Fatehpur,1981,56.98,84831,30166,55.18,45393,39438
241,Fatehpur,1991,56.98,117675,32844,38.72,62783,54892
241,Fatehpur,2001,56.98,152078,34403,29.24,80011,72067
241,Fatehpur,2011,56.98,193193,41115,27.03546864109207,101263,91930
242,Kasaragod U.A.,1961,30.119999999999997,34237,11529,50.77065351418002,16939,17298
242,Kasaragod U.A.,1971,30.1,43796,9559,27.92008645617315,22032,21764
242,Kasaragod U.A.,1981,16.68,43137,-659,-1.5047036259019089,21448,21689
242,Kasaragod U.A.,1991,16.68,50126,6989,16.20186846558639,24887,25239
242,Kasaragod U.A.,2001,32.09,84107,33981,67.79116626102223,40945,43162
242,Kasaragod U.A.,2011,104.11,192856,108749,129.29839371277063,92883,99973
243,Rae Bareli,1961,10.18,29940,4982,19.96,16292,13648
243,Rae Bareli,1971,10.2,38765,8825,29.48,20822,17943
243,Rae Bareli,1981,49.54,89697,50932,131.39,49392,40305
243,Rae Bareli,1991,50.12,129904,40207,44.83,70143,59761
243,Rae Bareli,2001,50.12,169333,39429,30.35,88911,80422
243,Rae Bareli,2011,50.12,191316,21983,12.982112169512144,99903,91413
244,Mahesana U.A.,1961,7.51,32577,9773,42.85651640063147,17420,15157
244,Mahesana U.A.,1971,12.87,51713,19136,58.74082941952912,27441,24272
244,Mahesana U.A.,1981,12.87,73024,21311,41.21014058360567,38020,35004
244,Mahesana U.A.,1991,NA,109950,36926,50.56693689745837,57565,52385
244,Mahesana U.A.,2001,NA,141453,31503,28.652114597544337,74866,66587
244,Mahesana U.A.,2011,31.76,190753,49300,34.852565869935596,100558,90195
245,Orai U.A.,1961,15.67,29587,8329,39.18,16598,12989
245,Orai U.A.,1971,15.67,42513,12926,43.69,23737,18776
245,Orai U.A.,1981,20.29,66397,23884,56.18,36539,29858
245,Orai U.A.,1991,20.29,98716,32319,48.68,53835,44881
245,Orai U.A.,2001,20.29,139318,40602,41.13,74703,64615
245,Orai U.A.,2011,25.7,190575,51257,36.79136938514765,101306,89269
246,Chhindwara U.A.,1961,11.01,37244,9592,34.69,19388,17856
246,Chhindwara U.A.,1971,11.33,53508,16264,43.67,27977,25531
246,Chhindwara U.A.,1981,11.01,75178,21670,40.5,39593,35585
246,Chhindwara U.A.,1991,12.21,96858,21680,28.84,50797,46061
246,Chhindwara U.A.,2001,22.01,153552,56694,58.53,79889,73663
246,Chhindwara U.A.,2011,47.199999999999996,190041,36489,23.763285401688027,97068,92973
247,Bhuj U.A.,1961,NA,40180,3953,10.911750904021861,20666,19514
247,Bhuj U.A.,1971,NA,62859,22679,56.44350423096067,32218,30641
247,Bhuj U.A.,1981,NA,81455,18596,29.583671391527066,42492,38963
247,Bhuj U.A.,1991,NA,121009,39554,48.55932723589712,64231,56778
247,Bhuj U.A.,2001,NA,136429,15420,12.742853837317886,71056,65373
247,Bhuj U.A.,2011,79.39,188236,51807,37.973597988697414,98715,89521
248,Sitapur U.A.,1961,25.9,53884,9487,21.37,29933,23951
248,Sitapur U.A.,1971,25.9,66715,12831,23.81,37194,29521
248,Sitapur U.A.,1981,25.9,101210,34495,51.71,55574,45636
248,Sitapur U.A.,1991,25.9,121842,20632,20.39,65571,56271
248,Sitapur U.A.,2001,25.9,151908,30066,24.68,79767,72141
248,Sitapur U.A.,2011,37,188115,36207,23.83482107591437,98374,89741
249,Bahraich,1961,12.43,56033,11292,25.24,30425,25608
249,Bahraich,1971,12.43,73931,17898,31.94,39931,34000
249,Bahraich,1981,13.2,99889,25958,35.11,53020,46869
249,Bahraich,1991,13.3,135400,35511,35.55,72372,63028
249,Bahraich,2001,13.3,168323,32923,24.32,89581,78742
249,Bahraich,2011,13.3,186223,17900,10.63431616594286,97653,88570
250,Veraval U.A.,1961,35.74,60857,8423,16.064004272037227,30878,29979
250,Veraval U.A.,1971,37.68,75520,14663,24.094188014525855,38758,36762
250,Veraval U.A.,1981,38.4,105307,29787,39.44253177966102,53926,51381
250,Veraval U.A.,1991,NA,120178,14871,14.12156836677524,61364,58814
250,Veraval U.A.,2001,41.010000000000005,158032,37854,31.49827755496014,80889,77143
250,Veraval U.A.,2011,45.07,185797,27765,17.569226485775033,94563,91234
251,Phusro U.A.,1961,63.14,60208,23837,65.53847845811224,33771,26437
251,Phusro U.A.,1971,72.9,69321,9113,15.135862343874567,38556,30765
251,Phusro U.A.,1981,79.03,101946,32625,47.06366036266066,56125,45821
251,Phusro U.A.,1991,84.1,142585,40639,39.86326094206737,78895,63690
251,Phusro U.A.,2001,85.75,174402,31817,22.314408949047937,93700,80702
251,Phusro U.A.,2011,90.33,185555,11153,6.3949954702354335,96958,88597
252,Adoni U.A.,1961,30.12,69951,16368,30.547001847600917,35597,34354
252,Adoni U.A.,1971,30.12,85311,15360,21.958227902388817,43480,41831
252,Adoni U.A.,1981,30.12,108939,23628,27.6963111439322,55643,53296
252,Adoni U.A.,1991,30.12,136182,27243,25.007573045465808,68958,67224
252,Adoni U.A.,2001,29.71,162458,26276,19.294767296705878,82345,80113
252,Adoni U.A.,2011,106.4,184625,22167,13.644757414223985,91736,92889
253,Modinagar U.A.,1961,10.36,24266,11962,97.22,14838,9428
253,Modinagar U.A.,1971,10.36,43470,19204,79.14,25713,17757
253,Modinagar U.A.,1981,14.36,87665,44195,101.67,48427,39238
253,Modinagar U.A.,1991,23.84,131752,44087,50.29030970170536,71104,60648
253,Modinagar U.A.,2001,22.95,139929,8177,6.206357398749165,74788,65141
253,Modinagar U.A.,2011,33.8,183075,43146,30.83420877730849,97423,85652
254,Sirsa,1961,5.18,33363,8383,33.55884707766213,18181,15182
254,Sirsa,1971,5.18,48808,15445,46.29379851931781,26522,22286
254,Sirsa,1981,19.33,89068,40260,82.48647762661858,49011,40057
254,Sirsa,1991,19.33,112841,23773,26.69084295145282,60573,52268
254,Sirsa,2001,26.43,160735,47894,42.44379259311775,85993,74742
254,Sirsa,2011,24.43,182534,21799,13.562074221544778,96175,86359
255,Krishnanagar U.A.,1961,15.8,70440,20398,40.76176012149794,36777,33663
255,Krishnanagar U.A.,1971,15.8,85923,15483,21.980408858603067,44655,41268
255,Krishnanagar U.A.,1981,15.8,98141,12218,14.21970834351687,50011,48130
255,Krishnanagar U.A.,1991,15.96,121110,22969,23.40408188218991,61404,59706
255,Krishnanagar U.A.,2001,17.810000000000002,148709,27599,22.78837420526794,75495,73214
255,Krishnanagar U.A.,2011,27.269900000000003,182010,33301,22.393399189020165,91993,90017
256,Karaikkudi U.A. $,1961,36.230000000000004,70121,9947,16.530395187290193,34339,35782
256,Karaikkudi U.A. $,1971,72.34,88371,18250,26.02644001083841,44476,43895
256,Karaikkudi U.A. $,1981,80.87,100141,11770,13.318848943657988,50312,49829
256,Karaikkudi U.A. $,1991,79,110926,10785,10.76981456146833,55793,55133
256,Karaikkudi U.A. $,2001,42.9,125717,14791,13.33411463498188,62479,63238
256,Karaikkudi U.A. $,2011,68.01,181851,56134,44.6510813971062,90799,91052
257,Guna 33,1961,22.76,31031,8810,39.65,16607,14424
257,Guna 33,1971,23.11,42330,11299,36.41,22750,19580
257,Guna 33,1981,NA,64659,22329,52.75,34295,30364
257,Guna 33,1991,45.75,100490,35831,55.42,53390,47100
257,Guna 33,2001,45.75,137175,36685,36.51,72538,64637
257,Guna 33,2011,45.75,180935,43760,31.90085657007472,94464,86471
258,Jaunpur,1961,25.25,61851,9500,18.15,33047,28804
258,Jaunpur,1971,25.25,80737,18886,30.53,43412,37325
258,Jaunpur,1981,25.25,105140,24403,30.23,56077,49063
258,Jaunpur,1991,25.25,136062,30922,29.41,72276,63786
258,Jaunpur,2001,25.25,160055,23993,17.63,84203,75852
258,Jaunpur,2011,25.3,180362,20307,12.687513667176908,93718,86644
259,Madanapalle U.A.,1961,4.58,24386,8244,51.0717383223888,12764,11622
259,Madanapalle U.A.,1971,7.77,36458,12072,49.50381366357746,18990,17468
259,Madanapalle U.A.,1981,7.77,54938,18480,50.688463437379994,28686,26252
259,Madanapalle U.A.,1991,7.74,73820,18882,34.36965306345335,37948,35872
259,Madanapalle U.A.,2001,12.5,107449,33629,45.55540503928475,54497,52952
259,Madanapalle U.A.,2011,23.44,180180,72731,67.68885703915346,90700,89480
260,Panvel,1961,12.15,18130,3269,21.99717381064531,9528,8602
260,Panvel,1971,12.15,26602,8472,46.72917815774959,13996,12606
260,Panvel,1981,12.15,37073,10471,39.361702127659576,19550,17523
260,Panvel,1991,12.15,58986,21913,59.107706417069025,30921,28065
260,Panvel,2001,12.17,104058,45072,76.41135184620079,54963,49095
260,Panvel,2011,12.17,180020,75962,72.99967325914393,92484,87536
261,Shivpuri 34,1961,7.17,28681,6794,31.04,15467,13214
261,Shivpuri 34,1971,NA,50858,22177,77.32,27683,23175
261,Shivpuri 34,1981,81.11,75738,24880,48.92,41144,34594
261,Shivpuri 34,1991,81.11,108277,32539,42.96,58385,49892
261,Shivpuri 34,2001,81.11,146892,38615,35.66,78433,68459
261,Shivpuri 34,2011,81.11,179977,33085,22.523350488794488,95132,84845
262,Neyveli U.A. $,1961,62.96,22481,12534,126.00784156026943,12354,10127
262,Neyveli U.A. $,1971,54.01,74303,51822,230.5146568213158,38114,36189
262,Neyveli U.A. $,1981,88.6,114977,40674,54.740723793117375,58840,56137
262,Neyveli U.A. $,1991,129.2,150006,35029,30.46609321864373,78360,71646
262,Neyveli U.A. $,2001,145.18,186934,36928,24.61768195938829,95452,91482
262,Neyveli U.A. $,2011,189.13000000000002,179150,-7784,-4.164036504862679,90392,88758
263,Baleshwar  U.A.,1961,17.61,33931,11080,48.49,18353,15578
263,Baleshwar  U.A.,1971,19.43,46239,12308,36.27,25246,20993
263,Baleshwar  U.A.,1981,19.43,65779,19540,42.26,35216,30563
263,Baleshwar  U.A.,1991,41.82,101829,36050,54.8,54551,47278
263,Baleshwar  U.A.,2001,68.7,156430,54601,53.62,82106,74324
263,Baleshwar  U.A.,2011,68.7,177751,21321,13.629738541200537,90773,86978
264,Unnao,1961,5.49,29780,4540,17.99,16693,13087
264,Unnao,1971,5.65,38195,8415,28.26,21112,17083
264,Unnao,1981,15.54,75983,37788,98.93,40965,35018
264,Unnao,1991,15.54,107425,31442,41.38,57287,50138
264,Unnao,2001,21.2,144662,37237,34.66,76254,68408
264,Unnao,2011,21.5,177658,32996,22.809030706059644,93021,84637
265,S.A.S. Nagar U.A.,1981,NA,32351,NA,NA,17801,14550
265,S.A.S. Nagar U.A.,1991,NA,78457,46106,142.51800562579209,42040,36417
265,S.A.S. Nagar U.A.,2001,NA,123484,45027,57.39067259772869,65642,57842
265,S.A.S. Nagar U.A.,2011,NA,176170,52686,42.666256357098895,92301,83869
266,Chittoor U.A.,1961,9.3,47876,8982,23.093536278089168,24432,23444
266,Chittoor U.A.,1971,9.3,63035,15159,31.663046202690282,32393,30642
266,Chittoor U.A.,1981,9.3,86230,23195,36.79701752994368,44253,41977
266,Chittoor U.A.,1991,33.47,133462,47232,54.774440449959414,67772,65690
266,Chittoor U.A.,2001,33.57,152654,19192,14.380123181130209,76879,75775
266,Chittoor U.A.,2011,46.02,175647,22993,15.062166729990697,87509,88138
267,Nabadwip U.A.,1961,11.66,72861,16563,29.42022807204519,37226,35635
267,Nabadwip U.A.,1971,11.66,94204,21343,29.292762932158496,48417,45787
267,Nabadwip U.A.,1981,16.16,129800,35596,37.78608127043437,65736,64064
267,Nabadwip U.A.,1991,18.28,155905,26105,20.11,78968,76937
267,Nabadwip U.A.,2001,16.59,131899,-24006,-15.4,66875,65024
267,Nabadwip U.A.,2011,23.2151,175479,43580,33.0404324521035,90940,84539
268,Cuddalore,1961,27.71,79168,10084,14.596722830177756,39796,39372
268,Cuddalore,1971,27.79,101335,22167,27.999949474535168,51290,50045
268,Cuddalore,1981,27.71,127625,26290,25.9436522425618,64918,62707
268,Cuddalore,1991,27.71,144561,16936,13.270127326150833,73245,71316
268,Cuddalore,2001,27.69,158634,14073,9.734990765144126,80012,78622
268,Cuddalore,2011,27.69,173636,15002,9.456989043962832,85700,87936
269,Hassan U.A.,1961,12.95,32172,7303,29.36587719650973,17060,15112
269,Hassan U.A.,1971,14.25,51325,19153,59.533134402586086,27490,23835
269,Hassan U.A.,1981,8.56,71534,20209,39.374573794447144,37564,33970
269,Hassan U.A.,1991,26.67,108706,37172,51.964100986943265,56487,52219
269,Hassan U.A.,2001,29.569999999999997,133262,24556,22.589369492024375,68242,65020
269,Hassan U.A.,2011,33.628299999999996,173008,39746,29.825456619291316,86133,86875
270,Gadag-Betigeri,1961,10.62,76614,11105,16.951869208811004,39825,36789
270,Gadag-Betigeri,1971,11.65,95426,18812,24.55425901271309,49785,45641
270,Gadag-Betigeri,1981,17.1,117368,21942,22.993733364072682,60581,56787
270,Gadag-Betigeri,1991,34.75,134051,16683,14.214266239520128,68789,65262
270,Gadag-Betigeri,2001,54.57,154982,20931,15.614206533334311,78713,76269
270,Gadag-Betigeri,2011,54.57,172612,17630,11.375514575886243,85920,86692
271,Shimla U.A.,1961,19.55,44084,NA,-4.4767063921993495,27615,16469
271,Shimla U.A.,1971,21.66,57323,13239,30.03130387442156,34371,22952
271,Shimla U.A.,1981,21.66,73004,15681,27.355511749210613,43628,29376
271,Shimla U.A.,1991,35.34,110360,37356,51.16979891512794,63661,46699
271,Shimla U.A.,2001,29.94,144975,34615,31.365530989488942,82840,62135
271,Shimla U.A.,2011,36.75,171640,26665,18.39282634937058,94586,77054
272,Bahadurgarh,1961,2.59,14982,3812,34.12712623097583,8001,6981
272,Bahadurgarh,1971,1.3,25812,10830,72.28674409291149,14155,11657
272,Bahadurgarh,1981,9,37488,11676,45.23477452347745,20262,17226
272,Bahadurgarh,1991,10,57235,19747,52.675522833973545,30757,26478
272,Bahadurgarh,2001,29.65,131925,74690,130.4970734690312,72873,59052
272,Bahadurgarh,2011,29.5,170767,38842,29.442486261133222,91721,79046
273,Valsad U.A.,1961,NA,44166,18726,73.60849056603773,22614,21552
273,Valsad U.A.,1971,NA,63069,18903,42.79989131911425,32982,30087
273,Valsad U.A.,1981,NA,82697,19628,31.121470135882923,43148,39549
273,Valsad U.A.,1991,NA,100881,18184,21.988705757161686,52185,48696
273,Valsad U.A.,2001,NA,145592,44711,44.32053607716021,75216,70376
273,Valsad U.A.,2011,35.9,170060,24468,16.805868454310676,86897,83163
274,Machilipatnam,1961,24.86,101417,23464,30.100188575167085,52095,49322
274,Machilipatnam,1971,23.93,112612,11195,11.038583274993345,57553,55059
274,Machilipatnam,1981,24.88,138530,25918,23.015309203282065,70068,68462
274,Machilipatnam,1991,26.67,159110,20580,14.855987872662963,80053,79057
274,Machilipatnam,2001,26.67,179353,20243,12.722644711206083,89100,90253
274,Machilipatnam,2011,26.67,169892,-9461,-5.275072064587713,83594,86298
275,Medinipur,1961,10.36,59532,14056,30.908611135544025,32859,26673
275,Medinipur,1971,10.36,71326,11794,19.811193979708392,39044,32282
275,Medinipur,1981,10.36,86118,14792,20.738580601744104,45263,40855
275,Medinipur,1991,14.78,125498,39380,45.72795466685246,65338,60160
275,Medinipur,2001,14.78,149769,24271,19.33975043426987,76503,73266
275,Medinipur,2011,18.36,169264,19495,13.016712403768471,84977,84287
276,Jalpaiguri U.A.,1961,10.08,48738,7479,18.12695411910129,27608,21130
276,Jalpaiguri U.A.,1971,10.08,55159,6421,13.17452501128483,30665,24494
276,Jalpaiguri U.A.,1981,10.08,61743,6584,11.936402037745426,32204,29539
276,Jalpaiguri U.A.,1991,10.08,68732,6989,11.319501805872731,35020,33712
276,Jalpaiguri U.A.,2001,12.5,100348,31616,45.99895245300588,50629,49719
276,Jalpaiguri U.A.,2011,70.9955,169002,68654,68.41591262406824,85218,83784
277,Hoshiarpur,1961,10.12,50739,5448,12.02887990991588,27981,22758
277,Hoshiarpur,1971,10.13,57691,6952,13.70149194899386,30844,26847
277,Hoshiarpur,1981,21.46,85648,27957,48.45989842436429,46018,39630
277,Hoshiarpur,1991,28.21,122705,37057,43.26662619092099,65378,57327
277,Hoshiarpur,2001,35,149668,26963,21.973839696833863,79454,70214
277,Hoshiarpur,2011,35,168653,18985,12.684742229467888,88304,80349
278,Jind,1961,24.27,24216,4767,24.51025759679161,13067,11149
278,Jind,1971,10.36,38161,13945,57.58589362405021,20811,17350
278,Jind,1981,15.3,56748,18587,48.706794895311965,30567,26181
278,Jind,1991,15.3,85315,28567,50.34010009163319,45972,39343
278,Jind,2001,15.3,135855,50540,59.23928969114458,73407,62448
278,Jind,2011,42,167592,31737,23.360936292370543,89253,78339
279,Kumbakonam U.A.,1961,14.79,96746,5103,5.568346736793863,48082,48664
279,Kumbakonam U.A.,1971,14.68,119655,22909,23.67953197031402,60086,59569
279,Kumbakonam U.A.,1981,14.67,141794,22139,18.502360954410594,71587,70207
279,Kumbakonam U.A.,1991,14.68,150540,8746,6.168103022694896,75691,74849
279,Kumbakonam U.A.,2001,17.6,160767,10227,6.793543244320446,80188,80579
279,Kumbakonam U.A.,2011,17.6,167155,6388,3.9734522632132214,82840,84315
280,Udupi U.A.,1961,18.91,35282,14831,72.5196811891839,17147,18135
280,Udupi U.A.,1971,38,54909,19627,55.62893260019274,27160,27749
280,Udupi U.A.,1981,24.2,59731,4822,8.781802618878515,29633,30098
280,Udupi U.A.,1991,73.01,117674,57943,97.00657949808306,59967,57707
280,Udupi U.A.,2001,73.01,127124,9450,8.030660978635893,62596,64528
280,Udupi U.A.,2011,94.01999999999998,165401,38277,30.109971366539753,81899,83502
281,Tonk,1961,50.94,43413,580,1.3540961408259988,22397,21016
281,Tonk,1971,14.53,55866,12453,28.684956119134817,29013,26853
281,Tonk,1981,14.53,77653,21787,38.998675401854435,40338,37315
281,Tonk,1991,16.03,100235,22582,29.080653677256514,51825,48410
281,Tonk,2001,60.5,135689,35454,35.37087843567616,70255,65434
281,Tonk,2011,60.5,165294,29605,21.818275615562058,84806,80488
282,Lakhimpur U.A.*,1961,4.97,32285,7230,28.86,17751,14534
282,Lakhimpur U.A.*,1971,4.97,43752,11467,35.52,24023,19729
282,Lakhimpur U.A.*,1981,6.99,61003,17251,39.43,32694,28309
282,Lakhimpur U.A.*,1991,6.99,79951,18948,31.06,42530,37421
282,Lakhimpur U.A.*,2001,6.99,121486,41535,51.95,65236,56250
282,Lakhimpur U.A.*,2011,12.12,165085,43599,35.88808586997679,87469,77616
283,Tenali,1961,6.94,78525,20409,35.11769564319637,39549,38976
283,Tenali,1971,7.9,102937,24412,31.08818847500796,52097,50840
283,Tenali,1981,7.9,119257,16320,15.854357519647941,60191,59066
283,Tenali,1991,15.11,143726,24469,20.51787316467796,72264,71462
283,Tenali,2001,15.11,153756,10030,6.978556419854446,77404,76352
283,Tenali,2011,15.11,164937,11181,7.271911340045266,81427,83510
284,Balurghat U.A.,1961,6.37,26999,8878,48.99,14619,12380
284,Balurghat U.A.,1971,6.37,67088,40089,148.48,35947,31141
284,Balurghat U.A.,1981,8.32,112621,45533,67.87,59347,53274
284,Balurghat U.A.,1991,8.32,126225,13604,12.08,64897,61328
284,Balurghat U.A.,2001,12.41,143321,17096,13.54,72764,70557
284,Balurghat U.A.,2011,16.39,164816,21495,15,82574,82242
285,Vapi ^,1961,12.28,11212,NA,NA,5667,5545
285,Vapi ^,1971,12.27,13888,2676,23.86728505173029,7325,6563
285,Vapi ^,1981,7.67,19620,5732,41.27304147465438,10579,9041
285,Vapi ^,1991,7.67,31533,11913,60.718654434250766,17034,14499
285,Vapi ^,2001,22.44,112177,80644,255.74477531474963,66216,45961
285,Vapi ^,2011,22.44,163630,51453,45.867691237954304,94105,69525
286,Mancherial U.A.,1961,17.48,13822,4825,53.628987440257866,7308,6514
286,Mancherial U.A.,1971,41.44,19808,5986,43.30777022138619,10462,9346
286,Mancherial U.A.,1981,41.44,32478,12670,63.96405492730211,16938,15540
286,Mancherial U.A.,1991,41.44,52657,20179,62.131288872467515,27275,25382
286,Mancherial U.A.,2001,62.44,118195,65538,124.46208481303532,60371,57824
286,Mancherial U.A.,2011,89.06,163552,45357,38.37471974279792,83799,79753
287,Moga U.A.,1961,NA,47779,11181,30.550849773211652,25661,22118
287,Moga U.A.,1971,NA,61625,13846,28.979258670127052,32675,28950
287,Moga U.A.,1981,NA,80272,18647,30.25882352941176,42488,37784
287,Moga U.A.,1991,NA,110958,30686,38.2275264102053,58957,52001
287,Moga U.A.,2001,NA,135279,24321,21.919104526036868,72043,63236
287,Moga U.A.,2011,NA,163397,28118,20.785192084506836,86604,76793
288,Rajnandgaon,1961,12.67,44678,21378,91.7510729613734,22978,21700
288,Rajnandgaon,1971,21.94,55827,11149,24.954116119790502,28898,26929
288,Rajnandgaon,1981,34,86367,30540,54.70471277338922,44765,41602
288,Rajnandgaon,1991,93.34,125371,39004,45.16076742274248,63960,61411
288,Rajnandgaon,2001,78.09,143770,18399,14.675642692488694,72949,70821
288,Rajnandgaon,2011,76.05,163114,19344,13.454823676705848,81929,81185
289,Chirala U.A.,1961,18.51,61213,8827,16.849921734814647,30703,30510
289,Chirala U.A.,1971,10.88,74153,12940,21.139300475389213,37246,36907
289,Chirala U.A.,1981,15.62,100601,26448,35.66679702776692,50449,50152
289,Chirala U.A.,1991,48.1,142778,42177,41.925030566296556,71233,71545
289,Chirala U.A.,2001,48.1,166294,23516,16.470324559806134,82954,83340
289,Chirala U.A.,2011,48.1,162471,-3823,-2.298940430803276,80019,82452
290,Godhra U.A. $,1961,20.07,52167,11691,28.883782982508155,27304,24863
290,Godhra U.A. $,1971,20.16,66853,14686,28.15189679299174,34991,31862
290,Godhra U.A. $,1981,20.16,86228,19375,28.981496716676887,44732,41496
290,Godhra U.A. $,1991,20.16,100662,14434,16.73934220902723,52350,48312
290,Godhra U.A. $,2001,23.33,131172,30510,30.309352089169693,67969,63203
290,Godhra U.A. $,2011,35.14,162436,31264,23.834354892812488,83913,78523
291,Robertson Pet U.A. £,1961,77.7,146811,-12273,-7.71479218526062,74015,72796
291,Robertson Pet U.A. £,1971,65.73,118861,-27950,-19.03808297743356,61304,57557
291,Robertson Pet U.A. £,1981,52.13,144385,25524,21.473822363937714,73220,71165
291,Robertson Pet U.A. £,1991,58.12,156746,12361,8.561138622433077,79386,77360
291,Robertson Pet U.A. £,2001,59.75,157084,338,0.21563548671097976,78578,78506
291,Robertson Pet U.A. £,2011,59.75,162230,5146,3.2759542665070853,80375,81855
292,Hathras U.A.,1961,8.34,64045,7426,13.12,34375,29670
292,Hathras U.A.,1971,8.34,74349,10304,16.09,40853,33496
292,Hathras U.A.,1981,8.33,92962,18613,25.03,50395,42567
292,Hathras U.A.,1991,8.33,113285,20323,21.86,60871,52414
292,Hathras U.A.,2001,8.43,126355,13070,11.54,67436,58919
292,Hathras U.A.,2011,12.1,160909,34554,27.34676110957224,85587,75322
293,Pathankot U.A.,1961,NA,54810,22395,69.08838500694124,32875,21935
293,Pathankot U.A.,1971,NA,78192,23382,42.66009852216749,41969,36223
293,Pathankot U.A.,1981,NA,110039,31847,40.7292306118273,57565,52474
293,Pathankot U.A.,1991,NA,128198,18159,16.502330991739292,67092,61106
293,Pathankot U.A.,2001,NA,168485,40287,31.425607263763865,92003,76482
293,Pathankot U.A.,2011,NA,160509,-7976,-4.733952577380776,84436,76073
294,Banda U.A.,1961,3.29,37744,7417,24.46,20285,17459
294,Banda U.A.,1971,3.29,50575,12831,33.99,27568,23007
294,Banda U.A.,1981,11.29,72379,21804,43.11,39663,32716
294,Banda U.A.,1991,11.29,96795,24416,33.73,52758,44037
294,Banda U.A.,2001,27.77,139436,42641,44.05,75174,64262
294,Banda U.A.,2011,27.48,160473,21037,15.087208468401272,85370,75103
295,Anantnag U.A.,1961,16.19,21087,4551,27.521770682148038,11513,9574
295,Anantnag U.A.,1971,8.53,32414,11327,53.71555934936217,17483,14931
295,Anantnag U.A.,1981,8.53,40782,8368,25.816005429752575,21479,19303
295,Anantnag U.A.,1991,NA,NA,NA,NA,NA,NA
295,Anantnag U.A.,2001,39.19,97896,NA,NA,52702,45194
295,Anantnag U.A.,2011,40.44,159838,61942,63.273269592220316,82813,77025
296,Budaun,1961,2.36,58770,5249,9.81,31918,26852
296,Budaun,1971,2.49,72204,13434,22.86,38826,33378
296,Budaun,1981,4.39,93004,20800,28.81,49882,43122
296,Budaun,1991,4.39,116695,23691,25.47,62086,54609
296,Budaun,2001,4.39,148029,31334,26.85,78141,69888
296,Budaun,2011,6.1,159285,11256,7.603915448999858,83176,76109
297,Batala U.A.,1961,NA,51300,-4550,-8.146821844225604,27419,23881
297,Batala U.A.,1971,NA,76488,25188,49.09941520467835,40421,36067
297,Batala U.A.,1981,NA,101966,25478,33.30980023010146,53926,48040
297,Batala U.A.,1991,NA,103367,1401,1.3739874075672232,54800,48567
297,Batala U.A.,2001,NA,147872,44505,43.05532713535267,78393,69479
297,Batala U.A.,2011,NA,158621,10749,7.269124648344515,83655,74966
298,Saharsa,1961,14.06,14803,NA,NA,8531,6272
298,Saharsa,1971,14.09,23217,8414,56.83982976423698,13325,9892
298,Saharsa,1981,19.13,57580,34363,148.0079252272042,32105,25475
298,Saharsa,1991,21.13,80149,22569,39.19590135463702,44470,35679
298,Saharsa,2001,21.13,125167,45018,56.16788730988533,67718,57449
298,Saharsa,2011,21.13,156540,31373,25.06491327586345,83291,73249
299,Pilibhit U.A,1961,3.47,57527,11302,24.45,31001,26526
299,Pilibhit U.A,1971,3.47,68273,10746,18.68,36898,31375
299,Pilibhit U.A,1981,9.97,88548,20275,29.7,47608,40940
299,Pilibhit U.A,1991,9.97,106605,18057,20.39,56722,49883
299,Pilibhit U.A,2001,9.97,124245,17640,16.55,65853,58392
299,Pilibhit U.A,2011,14.31,156263,32018,25.770051108696528,82407,73856
300,Vidisha 35,1961,5.83,27718,8534,44.48,15120,12598
300,Vidisha 35,1971,5.83,43212,15494,55.9,23515,19697
300,Vidisha 35,1981,5.83,65521,22309,51.63,35414,30107
300,Vidisha 35,1991,5.83,92922,27401,41.82,49650,43272
300,Vidisha 35,2001,5.83,125453,32531,35.01,66572,58881
300,Vidisha 35,2011,5.83,155951,30498,24.310299474703672,81488,74463
301,Bettiah U.A.,1961,8.68,39990,4356,12.224280181848796,21127,18863
301,Bettiah U.A.,1971,7.55,51018,11028,27.576894223555886,27032,23986
301,Bettiah U.A.,1981,7.55,72167,21149,41.45399662864087,38537,33630
301,Bettiah U.A.,1991,8.01,92653,20486,28.3869358571092,49633,43020
301,Bettiah U.A.,2001,8.01,116670,24017,25.921448846772364,61753,54917
301,Bettiah U.A.,2011,12.84,155518,38848,33.29733436187537,81808,73710
302,Thanesar,1961,15.54,16828,5555,49.277033620154356,9223,7605
302,Thanesar,1971,16.58,29555,12727,75.62990254338008,16888,12667
302,Thanesar,1981,20,49052,19497,65.96853324310608,27175,21877
302,Thanesar,1991,30.71,81255,32203,65.65073799233467,44156,37099
302,Thanesar,2001,35.7,122319,41064,50.5371977109101,66978,55341
302,Thanesar,2011,32.28,155152,32833,26.842109565970944,83994,71158
303,Kishangarh,1961,58.95,25244,-452,-1.7590286425902866,13421,11823
303,Kishangarh,1971,7.12,37405,12161,48.1738234828078,20570,16835
303,Kishangarh,1981,100,62032,24627,65.83879160540035,33065,28967
303,Kishangarh,1991,25.1,81948,19916,32.10600980139283,43322,38626
303,Kishangarh,2001,25.1,116222,34274,41.82408356518768,61075,55147
303,Kishangarh,2011,45.49,154886,38664,33.26736762402987,80024,74862
304,Rudrapur U.A.,1961,12.43,9662,NA,NA,5886,3776
304,Rudrapur U.A.,1971,12.43,25173,15511,160.54,14038,11135
304,Rudrapur U.A.,1981,12.43,34658,9485,37.68,18643,16015
304,Rudrapur U.A.,1991,12.43,61280,26622,76.81,32655,28625
304,Rudrapur U.A.,2001,12.43,88676,27396,44.71,47293,41383
304,Rudrapur U.A.,2011,27.65,154554,65878,74.29067616942578,81340,73214
305,Nalgonda U.A.,1961,12.79,24383,2200,9.91750439525763,12897,11486
305,Nalgonda U.A.,1971,12.77,33126,8743,35.856949514005656,17309,15817
305,Nalgonda U.A.,1981,12.77,62458,29332,88.54676085250257,33223,29235
305,Nalgonda U.A.,1991,14.14,84910,22452,35.947356623651096,44433,40477
305,Nalgonda U.A.,2001,51.01,111380,26470,31.174184430573547,56848,54532
305,Nalgonda U.A.,2011,123.54,154326,42946,38.5580894235949,77320,77006
306,Dibrugarh U.A.,1961,9.12,58480,20489,53.93119423021242,35427,23053
306,Dibrugarh U.A.,1971,10,80348,21868,37.39398084815321,46741,33607
306,Dibrugarh U.A.,1981,NA,NA,NA,NA,NA,NA
306,Dibrugarh U.A.,1991,16.13,125667,NA,NA,68830,56837
306,Dibrugarh U.A.,2001,25.83,137661,11994,9.544271765857385,73307,64354
306,Dibrugarh U.A.,2011,25.830000000000002,154296,16635,12.084032514655567,79757,74539
307,Jorhat U.A.,1961,4.95,24953,8789,54.373917347191295,15774,9179
307,Jorhat U.A.,1971,64.01,70674,45721,183.22846952270268,40653,30021
307,Jorhat U.A.,1981,NA,NA,NA,NA,NA,NA
307,Jorhat U.A.,1991,59.64,105364,NA,NA,57362,48002
307,Jorhat U.A.,2001,59.64,134117,28753,27.289206939751722,71329,62788
307,Jorhat U.A.,2011,59.64,153889,19772,14.742351827136007,79574,74315
308,Hazaribag U.A.,1961,18.39,40958,7146,21.134508458535432,22358,18600
308,Hazaribag U.A.,1971,26.34,54818,13860,33.839542946432935,29388,25430
308,Hazaribag U.A.,1981,26.35,80155,25337,46.220219635886025,43045,37110
308,Hazaribag U.A.,1991,26.35,97824,17669,22.043540640009983,52284,45540
308,Hazaribag U.A.,2001,27.22,135473,37649,38.48646548904154,72288,63185
308,Hazaribag U.A.,2011,27.22,153595,18122,13.376835236541599,79953,73642
309,Mughalsarai U.A.,1961,16.89,21086,5619,36.33,12494,8592
309,Mughalsarai U.A.,1971,16.89,28612,7526,35.69,16318,12294
309,Mughalsarai U.A.,1981,18.89,69224,40612,141.94,37971,31253
309,Mughalsarai U.A.,1991,18.89,91505,22281,32.19,49558,41947
309,Mughalsarai U.A.,2001,30.03,124061,32556,35.57838369488006,65573,58488
309,Mughalsarai U.A.,2011,33.31,152091,28030,22.593724055101926,80185,71906
310,Hindupur,1961,6.47,32445,8007,32.76454701694083,16683,15762
310,Hindupur,1971,6.47,42959,10514,32.405609492988134,22153,20806
310,Hindupur,1981,6.55,55901,12942,30.126399590307035,28984,26917
310,Hindupur,1991,38.16,104651,48750,87.2077422586358,53931,50720
310,Hindupur,2001,38.16,125074,20423,19.51534146830895,64132,60942
310,Hindupur,2011,38.16,151677,26603,21.269808273502086,76370,75307
311,Beawar U.A.,1961,11.94,53931,2877,5.635209777882242,28565,25366
311,Beawar U.A.,1971,6.67,66114,12183,22.589976080547366,34786,31328
311,Beawar U.A.,1981,17.69,89998,23884,36.12548023111595,47235,42763
311,Beawar U.A.,1991,17.74,106721,16723,18.58152403386742,55767,50954
311,Beawar U.A.,2001,24.17,125981,19260,18.047057280197897,65586,60395
311,Beawar U.A.,2011,25.17,151152,25171,19.97999698367214,77616,73536
312,Bhadravati@ *,1961,13.99,65776,23325,54.9457021036018,34880,30896
312,Bhadravati@ *,1971,12.21,101358,35582,54.0957188032109,53520,47838
312,Bhadravati@ *,1981,22.62,130606,29248,28.856133704295672,68154,62452
312,Bhadravati@ *,1991,34.66,149257,18651,14.280354654456914,76767,72490
312,Bhadravati@ *,2001,66.82,160662,11405,7.641182658099794,81351,79311
312,Bhadravati@ *,2011,66.82,151102,-9560,-5.950380301502534,75009,76093
313,Hanumangarh,1961,8.08,17909,11072,161.94237238554922,10043,7866
313,Hanumangarh,1971,8.91,32532,14623,81.65168351108382,17921,14611
313,Hanumangarh,1981,11.83,60071,27539,84.65203491946392,33366,26705
313,Hanumangarh,1991,13.45,82733,22662,37.72535832598092,44716,38017
313,Hanumangarh,2001,13.42,129556,46823,56.595312632202386,69532,60024
313,Hanumangarh,2011,13.420000000000073,150958,21402,16.51949736021489,79709,71249
314,Raigarh U.A.,1961,16.89,36933,7249,24.420563266406145,19512,17421
314,Raigarh U.A.,1971,21.14,48049,11116,30.097744564481626,25368,22681
314,Raigarh U.A.,1981,20.68,69791,21742,45.24964099148786,36986,32805
314,Raigarh U.A.,1991,20.68,90265,20474,29.336160823028756,47126,43139
314,Raigarh U.A.,2001,20.68,115908,25643,28.40857475211876,60101,55807
314,Raigarh U.A.,2011,33.73,150019,34111,29.42937502156883,76865,73154
315,Satara U.A.,1961,9.3,48709,7639,18.599951302654006,25600,23109
315,Satara U.A.,1971,8.16,66433,17724,36.38752591923463,35732,30701
315,Satara U.A.,1981,8.16,83336,16903,25.443680098746107,43972,39364
315,Satara U.A.,1991,7.69,95180,11844,14.212345204953442,49776,45404
315,Satara U.A.,2001,21.15,129552,34372,36.112628703509145,67260,62292
315,Satara U.A.,2011,21.15,149335,19783,15.270316166481413,76101,73234
316,Nagaon U.A.,1961,6.06,38600,10343,36.60331953144353,23295,15305
316,Nagaon U.A.,1971,6.22,56537,17937,46.468911917098445,33148,23389
316,Nagaon U.A.,1981,NA,NA,NA,NA,NA,NA
316,Nagaon U.A.,1991,9.22,93350,NA,NA,50074,43276
316,Nagaon U.A.,2001,15.86,123265,29915,32.04606320299946,64895,58370
316,Nagaon U.A.,2011,18.21,148496,25231,20.46890844927595,75425,73071
317,Hajipur,1961,25.9,34044,8895,35.369199570559466,17759,16285
317,Hajipur,1971,19.64,41890,7846,23.046645517565505,22275,19615
317,Hajipur,1981,19.64,62520,20630,49.248030556218666,33731,28789
317,Hajipur,1991,19.64,87687,25167,40.25431861804223,47101,40586
317,Hajipur,2001,19.64,119412,31725,36.17982141024325,63838,55574
317,Hajipur,2011,19.64,147688,28276,23.679362208153286,78047,69641
318,Damoh U.A.,1961,15.51,46656,9692,26.22,24469,22187
318,Damoh U.A.,1971,16.07,59983,13327,28.56,31619,28364
318,Damoh U.A.,1981,15.91,76758,16775,27.97,40644,36114
318,Damoh U.A.,1991,35.65,105043,28285,36.85,55460,49583
318,Damoh U.A.,2001,35.65,127967,22924,21.82,67321,60646
318,Damoh U.A.,2011,35.25000000000001,147661,19694,15.389905209936938,77132,70529
319,Barabanki U.A.,1961,8.62,34334,5376,18.56,19250,15084
319,Barabanki U.A.,1971,8.67,43385,9051,26.36,24371,19014
319,Barabanki U.A.,1981,8.67,62216,18831,43.4,34188,28028
319,Barabanki U.A.,1991,8.67,77234,15018,24.14,41327,35907
319,Barabanki U.A.,2001,9.38,92687,15453,20.01,49282,43405
319,Barabanki U.A.,2011,17.97,147550,54863,59.19168815475741,78328,69222
320,Chhatarpur U.A.,1961,17.07,22146,8036,56.95,11916,10230
320,Chhatarpur U.A.,1971,14.17,32271,10125,45.72,17626,14645
320,Chhatarpur U.A.,1981,14.17,51959,19688,61.01,28111,23848
320,Chhatarpur U.A.,1991,14.51,75594,23635,45.49,40885,34709
320,Chhatarpur U.A.,2001,16.78,109078,33484,44.2945207291584,58421,50657
320,Chhatarpur U.A.,2011,18.32,147505,38427,35.228918755386054,77977,69528
321,Sasaram,1961,5.18,37782,8517,29.10302409021015,19540,18242
321,Sasaram,1971,7.04,48282,10500,27.79101159282198,25545,22737
321,Sasaram,1981,10.9,73457,25175,52.14158485563978,39132,34325
321,Sasaram,1991,10.9,98122,24665,33.57746708958983,51928,46194
321,Sasaram,2001,10.9,131172,33050,33.682558447646805,69682,61490
321,Sasaram,2011,10.9,147408,16236,12.377641569847224,77599,69809
322,Srikakulam U.A.,1961,13.6,35071,10859,44.84966132496283,17704,17367
322,Srikakulam U.A.,1971,11.34,45179,10108,28.82153346069402,22977,22202
322,Srikakulam U.A.,1981,14.12,68145,22966,50.83335177848115,34509,33636
322,Srikakulam U.A.,1991,14.12,88883,20738,30.432166703353143,44801,44082
322,Srikakulam U.A.,2001,14.12,117320,28437,31.993744585578792,58753,58567
322,Srikakulam U.A.,2011,29.63,147015,29695,25.31111489942039,73028,73987
323,Bhimavaram U.A.,1961,23.31,43821,12893,41.687144335230215,22585,21236
323,Bhimavaram U.A.,1971,25.64,63762,19941,45.50557951667009,32681,31081
323,Bhimavaram U.A.,1981,25.64,101894,38132,59.80364480411531,52703,49191
323,Bhimavaram U.A.,1991,26.14,121314,19420,19.059022121027734,61676,59638
323,Bhimavaram U.A.,2001,26.14,142064,20750,17.104373773843086,71929,70135
323,Bhimavaram U.A.,2011,26.14,146961,4897,3.4470379547246313,72441,74520
324,Bid,1961,69.18,33066,7430,28.98268060539866,17171,15895
324,Bid,1971,69.18,49965,16899,51.10687715478135,26606,23359
324,Bid,1981,8.29,80287,30322,60.68648053637546,42064,38223
324,Bid,1991,8.29,112434,32147,40.04010611929702,59537,52897
324,Bid,2001,8.29,138196,25762,22.912997847626162,71827,66369
324,Bid,2011,8.29,146709,8513,6.160091464297085,75566,71143
325,Chitradurga U.A.,1961,6.47,33336,8255,32.91336071129541,18125,15211
325,Chitradurga U.A.,1971,8.2,50254,16918,50.74994000479961,27553,22701
325,Chitradurga U.A.,1981,10.97,74580,24326,48.406097027102334,39552,35028
325,Chitradurga U.A.,1991,16.47,103435,28855,38.6899973183159,54055,49380
325,Chitradurga U.A.,2001,25.98,125170,21735,21.01319669357568,64112,61058
325,Chitradurga U.A.,2011,25.98,145853,20683,16.52392745865623,73020,72833
326,Abohar,1961,14.17,46863,21387,83.94959962317475,25690,21173
326,Abohar,1971,14.17,58925,12062,25.73885581375499,31851,27074
326,Abohar,1981,14.17,86334,27409,46.51506151887993,46582,39752
326,Abohar,1991,23.07,107163,20829,24.12606852456738,57875,49288
326,Abohar,2001,23.07,124339,17176,16.027920084357476,66445,57894
326,Abohar,2011,23.07,145302,20963,16.859553317945295,76984,68318
327,Tiruvannamalai,1961,13.21,46441,5723,14.055208998477331,23547,22894
327,Tiruvannamalai,1971,13.37,61370,14929,32.14616394995801,31550,29820
327,Tiruvannamalai,1981,13.37,89462,28092,45.7748085383738,45773,43689
327,Tiruvannamalai,1991,13.64,109196,19734,22.05852764302162,55477,53719
327,Tiruvannamalai,2001,13.64,130567,21371,19.571229715374187,66125,64442
327,Tiruvannamalai,2011,13.64,145278,14711,11.267012338492881,72406,72872
328,Kaithal,1961,5.44,34890,6468,22.757019210470762,18657,16233
328,Kaithal,1971,7.9,45199,10309,29.54714817999427,24359,20840
328,Kaithal,1981,7.9,58385,13186,29.173211796721166,31311,27074
328,Kaithal,1991,7.9,71142,12757,21.849790185835403,37669,33473
328,Kaithal,2001,43.75,117285,46143,64.8604200050603,63098,54187
328,Kaithal,2011,43.74,144915,27630,23.557999744212815,76794,68121
329,Giridih  U.A.,1961,8.03,36881,7714,26.44769774059725,19607,17274
329,Giridih  U.A.,1971,7.76,40308,3427,9.29204739567799,21663,18645
329,Giridih  U.A.,1981,9.75,65444,25136,62.35982931428005,35011,30433
329,Giridih  U.A.,1991,9.75,78097,12653,19.334087158486646,41810,36287
329,Giridih  U.A.,2001,11.35,105634,27537,35.25999718299038,55490,50144
329,Giridih  U.A.,2011,16.37,143630,37996,35.96947952363822,74901,68729
330,Rewari  #,1961,6.06,36994,2912,8.544099524675781,19445,17549
330,Rewari  #,1971,6.06,43885,6891,18.627344974860787,23327,20558
330,Rewari  #,1981,6.06,51562,7677,17.493448786601345,27405,24157
330,Rewari  #,1991,18.43,75342,23780,46.11923509561305,39826,35516
330,Rewari  #,2001,19.66,105138,29796,39.54766265827825,56330,48808
330,Rewari  #,2011,22.5,143021,37883,36.03169168140919,75764,67257
331,Basirhat UA,1961,22.01,53943,19120,54.91,28440,25503
331,Basirhat UA,1971,22.01,63816,9873,18.3,32876,30940
331,Basirhat UA,1981,22.01,81040,17224,26.99,41599,39441
331,Basirhat UA,1991,22.01,101409,20369,25.13,52180,49229
331,Basirhat UA,2001,22.01,113159,11750,11.59,57965,55194
331,Basirhat UA,2011,29.86,143007,29848,26.38,72296,70711
332,Khurja U.A.,1961,3.37,41491,3029,7.88,22394,19097
332,Khurja U.A.,1971,10.36,50245,8754,21.1,26933,23312
332,Khurja U.A.,1981,10.36,67119,16874,33.58,35698,31421
332,Khurja U.A.,1991,10.36,80305,13186,19.65,42736,37569
332,Khurja U.A.,2001,10.36,98610,18305,22.79,52010,46600
332,Khurja U.A.,2011,29.36,142590,43980,44.59993915424399,75149,67441
333,Mandsaur,1961,6.19,41876,7335,21.24,21983,19893
333,Mandsaur,1971,6.66,56988,15112,36.09,29902,27086
333,Mandsaur,1981,10.32,77603,20615,36.17,40370,37233
333,Mandsaur,1991,10.32,95907,18304,23.59,49807,46100
333,Mandsaur,2001,10.36,117555,21648,22.57,60859,56696
333,Mandsaur,2011,36.36,141667,24112,20.511250053166602,72488,69179
334,Palanpur U.A.,1961,14.25,29139,6510,28.768394537982232,15291,13848
334,Palanpur U.A.,1971,14.92,42114,12975,44.52795222897148,21786,20328
334,Palanpur U.A.,1981,14.92,61262,19148,45.46706558389134,31732,29530
334,Palanpur U.A.,1991,NA,90269,29007,47.34909079037576,46973,43296
334,Palanpur U.A.,2001,39.5,122300,32031,35.48394243871096,64365,57935
334,Palanpur U.A.,2011,39.5,141592,19292,15.774325429272281,74088,67504
335,Anklesvar U.A.,1961,3.63,20287,5012,32.811783960720135,10453,9834
335,Anklesvar U.A.,1971,NA,26220,5933,29.24532952136836,13438,12782
335,Anklesvar U.A.,1981,NA,43700,17480,66.66666666666666,23183,20517
335,Anklesvar U.A.,1991,NA,78100,34400,78.71853546910755,42273,35827
335,Anklesvar U.A.,2001,NA,112643,34543,44.2291933418694,60249,52394
335,Anklesvar U.A.,2011,31.35,139578,26935,23.911827632431663,74599,64979
336,Adilabad U.A.,1961,20.07,20970,3774,21.946964410327983,10777,10193
336,Adilabad U.A.,1971,20.07,30368,9398,44.81640438721984,15705,14663
336,Adilabad U.A.,1981,20.07,53482,23114,76.11301369863014,27827,25655
336,Adilabad U.A.,1991,23.45,84255,30773,57.53898507909203,43560,40695
336,Adilabad U.A.,2001,20.7,129403,45148,53.58495044804462,65501,63902
336,Adilabad U.A.,2011,20.7,139383,9980,7.7123405176077835,70762,68621
337,Gonda U.A.,1961,10.57,43496,10930,33.56,23847,19649
337,Gonda U.A.,1971,10.57,52662,9166,21.07,29123,23539
337,Gonda U.A.,1981,12.67,70847,18185,34.53,38798,32049
337,Gonda U.A.,1991,12.67,95553,24706,34.87,51721,43832
337,Gonda U.A.,2001,15,120301,24748,25.9,66207,54094
337,Gonda U.A.,2011,33.43,138632,18331,15.237612322424585,73012,65620
338,Kolar,1961,3.89,32587,5411,19.910950838975566,16924,15663
338,Kolar,1971,3.89,43418,10831,33.23718047073987,22514,20904
338,Kolar,1981,4.24,65834,22416,51.62835690266709,34071,31763
338,Kolar,1991,7.91,83287,17453,26.510617613998846,42490,40797
338,Kolar,2001,18.3,113907,30620,36.764441029212236,58060,55847
338,Kolar,2011,18.3,138462,24555,21.557059706602757,69910,68552
339,Yavatmal U.A.,1961,8.37,45587,9607,26.70094496942746,24045,21542
339,Yavatmal U.A.,1971,8.37,64836,19249,42.22475705793318,34094,30742
339,Yavatmal U.A.,1981,10.17,89071,24235,37.378925288420014,46472,42599
339,Yavatmal U.A.,1991,13.47,121816,32745,36.76280719875156,63325,58491
339,Yavatmal U.A.,2001,13.47,139835,18019,14.791981348919684,71908,67927
339,Yavatmal U.A.,2011,13.47,138303,-1532,-1.095576929953159,69687,68616
340,Bankura,1961,18.13,62833,13464,27.27,33473,29360
340,Bankura,1971,18.13,79129,16296,25.94,41594,37535
340,Bankura,1981,19.06,94954,15825,20,49420,45534
340,Bankura,1991,19.06,114876,19922,20.98,59874,55002
340,Bankura,2001,19.06,128781,13905,12.1,66429,62352
340,Bankura,2011,19.06,137386,8605,6.68,69843,67543
341,Mandya @,1961,5.18,33347,12189,57.60941487853296,17928,15419
341,Mandya @,1971,16.84,72132,38785,116.30731400125947,38236,33896
341,Mandya @,1981,16.84,100285,28153,39.029834192868634,52517,47768
341,Mandya @,1991,16.84,120265,19980,19.923218826344907,62544,57721
341,Mandya @,2001,16.89,131179,10914,9.07495946451587,66551,64628
341,Mandya @,2011,16.89,137358,6179,4.710357602969978,68662,68696
342,Dehri,1961,9.22,38092,13596,55.50293925538864,22723,15369
342,Dehri,1971,15.78,46037,7945,20.8573978788197,26689,19348
342,Dehri,1981,21.32,90409,44372,96.38334383213503,50488,39921
342,Dehri,1991,21.32,93594,3185,3.5228793593558163,50661,42933
342,Dehri,2001,21.32,119057,25463,27.205803790841294,63540,55517
342,Dehri,2011,21.32,137231,18174,15.264957121378837,72372,64859
343,Mainpuri U.A.,1961,7.77,33610,10678,46.56,18378,15232
343,Mainpuri U.A.,1971,7.77,43849,10239,30.46,23738,20111
343,Mainpuri U.A.,1981,7.77,58928,15079,34.39,31635,27293
343,Mainpuri U.A.,1991,7.77,76735,17807,30.22,40837,35898
343,Mainpuri U.A.,2001,17,104851,28116,36.640385743141984,55462,49389
343,Mainpuri U.A.,2011,13.5,136557,31706,30.239101200751545,71274,65283
344,Kamptee U.A.,1961,21.03,46643,10478,28.972763721830496,24314,22329
344,Kamptee U.A.,1971,24.16,70983,24340,52.18360740089617,38163,32820
344,Kamptee U.A.,1981,24.38,94665,23682,33.362917881746334,51260,43405
344,Kamptee U.A.,1991,36.46,127151,32486,34.31680135213648,66709,60442
344,Kamptee U.A.,2001,37.06,136491,9340,7.345596967385235,71270,65221
344,Kamptee U.A.,2011,37.06,135936,-555,-0.4066202167175858,70255,65681
345,Malerkotla,1961,4.22,39543,6968,21.390636991557944,20905,18638
345,Malerkotla,1971,4.22,48859,9316,23.5591634423286,25916,22943
345,Malerkotla,1981,4.25,65756,16897,34.583188358337246,34831,30925
345,Malerkotla,1991,4.25,88600,22844,34.74055599489021,46978,41622
345,Malerkotla,2001,21.12,107009,18409,20.77765237020317,56767,50242
345,Malerkotla,2011,31.16,135424,28415,26.55,71376,64048
346,Pollachi U.A.,1961,13.85,54369,12625,30.24386738213875,28013,26356
346,Pollachi U.A.,1971,34.22,89133,34764,63.940848645367765,46150,42983
346,Pollachi U.A.,1981,34.18,109021,19888,22.312723682586697,56230,52791
346,Pollachi U.A.,1991,34.18,119765,10744,9.854982067675035,61025,58740
346,Pollachi U.A.,2001,29.29,128458,8693,7.2583809961173955,64657,63801
346,Pollachi U.A.,2011,29.269999999999996,135333,6875,5.351943825997602,67285,68048
347,Siwan,1961,3.88,27370,4745,20.972375690607734,14700,12670
347,Siwan,1971,3.14,33162,5792,21.161856046766534,17668,15494
347,Siwan,1981,3.14,51284,18122,54.64688498884265,27402,23882
347,Siwan,1991,12.19,83125,31841,62.08759067155448,44164,38961
347,Siwan,2001,13.05,109919,26794,32.233383458646614,58262,51657
347,Siwan,2011,13.05,135066,25147,22.877755438095324,70756,64310
348,Chakdaha U.A.,1961,15.54,35089,19717,128.2656778558418,17990,17099
348,Chakdaha U.A.,1971,15.54,46345,11256,32.07842913733649,23964,22381
348,Chakdaha U.A.,1981,15.54,59308,12963,27.970654871075627,30103,29205
348,Chakdaha U.A.,1991,17.47,80705,21397,36.07776353948877,41106,39599
348,Chakdaha U.A.,2001,19,101320,20615,25.543646614212257,51485,49835
348,Chakdaha U.A.,2011,23.939400000000003,133856,32536,32.112120015791554,67566,66290
349,Patan U.A.,1961,NA,51953,8909,20.697425889787194,26566,25387
349,Patan U.A.,1971,13.68,64519,12566,24.187246164802804,33206,31313
349,Patan U.A.,1981,13.62,79196,14677,22.748337698972396,40890,38306
349,Patan U.A.,1991,NA,97025,17829,22.512500631345016,50291,46734
349,Patan U.A.,2001,NA,113749,16724,17.236794640556557,59955,53794
349,Patan U.A.,2011,17.82,133737,19988,17.57202261118779,69898,63839
350,Khargone U.A.,1961,10.13,30652,9890,47.64,16055,14597
350,Khargone U.A.,1971,10.39,41316,10664,34.79,21646,19670
350,Khargone U.A.,1981,10,52749,11433,27.67,27906,24843
350,Khargone U.A.,1991,10,66786,14037,26.61,35109,31677
350,Khargone U.A.,2001,32.67,103448,36662,54.89,53921,49527
350,Khargone U.A.,2011,32.669999999999995,133368,29920,28.92274379398345,68663,64705
351,Lalitpur,1961,12.51,25220,4428,21.3,13372,11848
351,Lalitpur,1971,12.51,34462,9242,36.65,18265,16197
351,Lalitpur,1981,17.35,55756,21294,61.79,29653,26103
351,Lalitpur,1991,17.35,79870,24114,43.25,42317,37553
351,Lalitpur,2001,17.35,111892,32022,40.09,58993,52899
351,Lalitpur,2011,17.35,133305,21413,19.137203732170306,69529,63776
352,Dhaulpur U.A.,1961,8.21,27412,6761,32.73933465691735,15010,12402
352,Dhaulpur U.A.,1971,8.21,31865,4453,16.24471034583395,17262,14603
352,Dhaulpur U.A.,1981,8.21,44375,12510,39.259375490349925,24063,20312
352,Dhaulpur U.A.,1991,32.03,68533,24158,54.4405633802817,37189,31344
352,Dhaulpur U.A.,2001,32.32,97795,29262,42.69767849065414,52466,45329
352,Dhaulpur U.A.,2011,32.31999999999999,133075,35280,36.075463980776135,71298,61777
353,Gondiya,1961,18.08,56320,19634,53.51905358992531,29643,26677
353,Gondiya,1971,18.08,77992,21672,38.48011363636364,40699,37293
353,Gondiya,1981,18.08,100423,22431,28.76064211714022,51395,49028
353,Gondiya,1991,18.11,109470,9047,9.00889238521056,56202,53268
353,Gondiya,2001,18.11,120902,11432,10.44304375628026,61418,59484
353,Gondiya,2011,18.11,132813,11911,9.851780781128518,66500,66313
354,Ramgarh  U.A.,1961,36,20041,5266,35.64128595600677,12233,7808
354,Ramgarh  U.A.,1971,50.24,37923,17882,89.22708447682251,21272,16651
354,Ramgarh  U.A.,1981,50.24,65268,27345,72.1066371331382,38114,27154
354,Ramgarh  U.A.,1991,50.24,82328,17060,26.138383281240422,46400,35928
354,Ramgarh  U.A.,2001,50.24,110496,28168,34.21436206393936,61591,48905
354,Ramgarh  U.A.,2011,53.82,132425,21929,19.84596727483348,70906,61519
355,Palwal U.A.,1961,5.18,27863,13948,100.23715415019763,14657,13206
355,Palwal U.A.,1971,5.52,36207,8344,29.946524064171122,19538,16669
355,Palwal U.A.,1981,5.52,47328,11121,30.71505509984257,25303,22025
355,Palwal U.A.,1991,5.52,59168,11840,25.01690331304936,31371,27797
355,Palwal U.A.,2001,8.3,100722,41554,70.23053001622499,53648,47074
355,Palwal U.A.,2011,8.42,131926,31204,30.980322074621235,69997,61929
356,Etah U.A.,1961,5.18,24719,6505,35.71,13596,11123
356,Etah U.A.,1971,5.18,33514,8795,35.58,18322,15192
356,Etah U.A.,1981,5.18,53784,20270,60.48,28679,25105
356,Etah U.A.,1991,5.18,78458,24674,45.88,41902,36556
356,Etah U.A.,2001,13.49,107110,28652,36.52,56763,50347
356,Etah U.A.,2011,17.23,130931,23821,22.239753524414155,69097,61834
357,Dohad U.A.,1961,9.22,50434,8428,20.063800409465316,26443,23991
357,Dohad U.A.,1971,NA,69224,18790,37.25661260260935,35533,33691
357,Dohad U.A.,1981,NA,82256,13032,18.825840748873222,41899,40357
357,Dohad U.A.,1991,NA,96632,14376,17.477144524411592,49785,46847
357,Dohad U.A.,2001,26.01,112026,15394,15.930540607666197,57642,54384
357,Dohad U.A.,2011,26.009999999999998,130503,18477,16.49349258207916,66507,63996
358,Rajapalayam $,1961,10.36,71203,10342,16.99281970391548,35865,35338
358,Rajapalayam $,1971,9.75,86952,15749,22.118450065306234,43845,43107
358,Rajapalayam $,1981,11.36,101640,14688,16.89207838807618,51769,49871
358,Rajapalayam $,1991,11.36,114202,12562,12.359307359307358,57943,56259
358,Rajapalayam $,2001,9.75,122307,8105,7.0970736064167,61221,61086
358,Rajapalayam $,2011,11.36,130442,8135,6.651295510477732,64765,65677
359,Darjiling U.A.,1961,10.57,40651,7046,20.97,22736,17915
359,Darjiling U.A.,1971,10.57,42873,2222,5.47,22986,19887
359,Darjiling U.A.,1981,10.57,57603,14730,34.36,30932,26671
359,Darjiling U.A.,1991,10.57,73062,15459,26.84,37763,35299
359,Darjiling U.A.,2001,10.57,107197,34135,46.72,55963,51234
359,Darjiling U.A.,2011,20.92,130399,23202,21.64,64913,65486
360,Botad,1961,10.36,26168,6610,33.79691174966766,13595,12573
360,Botad,1971,10.36,32179,6011,22.97080403546316,16720,15459
360,Botad,1981,10.36,50274,18095,56.23232542962802,25643,24631
360,Botad,1991,10.36,64603,14329,28.50181008075745,33375,31228
360,Botad,2001,10.36,100194,35591,55.0918687986626,52752,47442
360,Botad,2011,10.36,130327,30133,30.074655168972193,67675,62652
361,Gangapur City U.A.,1961,3.45,22591,8513,60.47023724960931,12398,10193
361,Gangapur City U.A.,1971,3.44,32660,10069,44.570846797397195,17776,14884
361,Gangapur City U.A.,1981,6.95,46026,13366,40.92467850581751,24749,21277
361,Gangapur City U.A.,1991,9.95,68886,22860,49.6675791943684,37070,31816
361,Gangapur City U.A.,2001,11.85,105396,36510,53.000609702987546,56009,49387
361,Gangapur City U.A.,2011,53.6,130061,24665,23.40221640289954,68551,61510
362,Deoria,1961,16.19,28407,8251,40.94,16450,11957
362,Deoria,1971,16.19,38161,9754,34.34,21531,16630
362,Deoria,1981,16.19,55720,17559,46.01,30406,25314
362,Deoria,1991,16.19,82168,26448,47.47,44376,37792
362,Deoria,2001,16.19,104227,22059,26.85,54681,49546
362,Deoria,2011,16.19,129479,25252,24.227887207729285,67462,62017
363,Bhadrak U.A.,1961,25.38,25285,6490,34.53,13358,11927
363,Bhadrak U.A.,1971,31.08,40487,15202,60.12,21795,18692
363,Bhadrak U.A.,1981,31.08,60600,20113,49.68,32444,28156
363,Bhadrak U.A.,1991,31.08,76435,15835,26.13,40358,36077
363,Bhadrak U.A.,2001,31.08,92515,16080,21.04,48063,44452
363,Bhadrak U.A.,2011,49.96,129228,36713,39.683294600875534,66320,62908
364,Neemuch U.A.,1961,13.42,36287,8098,28.73,19583,16704
364,Neemuch U.A.,1971,13.77,49748,13461,37.1,26816,22932
364,Neemuch U.A.,1981,13.48,68853,19105,38.4,36567,32286
364,Neemuch U.A.,1991,13.48,90474,21621,31.4,47655,42819
364,Neemuch U.A.,2001,13.48,112852,22378,24.73,59320,53532
364,Neemuch U.A.,2011,22.04,128561,15709,13.920001417786127,67890,60671
365,Khanna,1961,19.63,24416,11770,93.07290842954295,12945,11471
365,Khanna,1971,19.63,34820,10404,42.61140235910879,18535,16285
365,Khanna,1981,21.06,53761,18941,54.39689833429065,28610,25151
365,Khanna,1991,16.02,71990,18229,33.907479399564735,38094,33896
365,Khanna,2001,24.75,103099,31109,43.21294624253369,55276,47823
365,Khanna,2011,24.75,128137,25038,24.285395590645884,67801,60336
366,Changanassery U.A.,1961,13.26,42376,6087,16.77367797404172,21389,20987
366,Changanassery U.A.,1971,NA,48545,6169,14.55776854823485,24195,24350
366,Changanassery U.A.,1981,13.5,51955,3410,7.024410340920795,25616,26339
366,Changanassery U.A.,1991,13.5,52445,490,0.9431238571841017,26011,26434
366,Changanassery U.A.,2001,13.5,51967,-478,-0.9114310229764515,25149,26818
366,Changanassery U.A.,2011,43.98,127987,76020,146.28514249427522,61807,66180
367,Alipurduar U.A.,1961,9.3,28927,4041,16.238045487422646,16346,12581
367,Alipurduar U.A.,1971,16.5,54454,25527,88.24627510630208,29449,25005
367,Alipurduar U.A.,1981,19.53,71573,17119,31.437543614794137,37842,33731
367,Alipurduar U.A.,1991,25.85,102815,31242,43.6505386109287,53193,49622
367,Alipurduar U.A.,2001,28.69,124046,21231,20.64971064533385,63669,60377
367,Alipurduar U.A.,2011,34.8147,126891,2845,2.293504022701256,64499,62392
368,Puruliya U.A.,1961,13.93,48134,6673,16.094643158631,25618,22516
368,Puruliya U.A.,1971,13.93,57708,9574,19.89030622844559,30400,27308
368,Puruliya U.A.,1981,13.93,73904,16196,28.065432868926322,38601,35303
368,Puruliya U.A.,1991,13.9,92386,18482,25.00811864039835,48422,43964
368,Puruliya U.A.,2001,13.9,113806,21420,23.18533111077436,59092,54714
368,Puruliya U.A.,2011,20.1715,126815,13009,11.430856018136126,65354,61461
369,Tinsukia U.A.,1961,10.36,28468,16223,132.48672927725602,18333,10135
369,Tinsukia U.A.,1971,10.36,54911,26443,92.88675003512716,33313,21598
369,Tinsukia U.A.,1981,NA,NA,NA,NA,NA,NA
369,Tinsukia U.A.,1991,10.54,73918,NA,NA,42400,31518
369,Tinsukia U.A.,2001,26.29,108123,34205,46.2742498444222,59561,48562
369,Tinsukia U.A.,2011,26.666000000000004,126389,18266,16.89372288967195,67404,58985
370,Guntakal,1961,51.9,48083,16742,53.418844325324656,24881,23202
370,Guntakal,1971,51.9,66320,18237,37.92816587983279,34199,32121
370,Guntakal,1981,51.9,84599,18279,27.561821471652593,43497,41102
370,Guntakal,1991,51.93,107592,22993,27.178808260144923,54630,52962
370,Guntakal,2001,40.87,117103,9511,8.839876570748755,59211,57892
370,Guntakal,2011,40.87,126270,9167,7.828151285620351,62851,63419
371,Pithampur,1991,11.3,11980,NA,NA,7563,4417
371,Pithampur,2001,75.51,68080,56100,468.28,39730,28350
371,Pithampur,2011,75.51,126200,58120,85.3701527614571,70250,55950
372,Motihari#,1961,22.35,34602,8696,33.567513317378214,20136,14466
372,Motihari#,1971,14.290000000000001,40352,5750,16.61753655858043,23345,17007
372,Motihari#,1981,15.11,63212,22860,56.651467089611415,35549,27663
372,Motihari#,1991,15.11,83255,20043,31.707587166993612,46035,37220
372,Motihari#,2001,16.380000000000003,108428,25173,30.236021860548917,59148,49280
372,Motihari#,2011,16.38,126158,17730,16.351864831962224,67861,58297
373,Jagdalpur  &,1961,9.59,20412,6619,47.988109910824335,10797,9615
373,Jagdalpur  &,1971,24.84,36932,16520,80.93278463648834,19708,17224
373,Jagdalpur  &,1981,23.03,63632,26700,72.29502870139716,33561,30071
373,Jagdalpur  &,1991,23.75,84578,20946,32.91740005028917,43660,40918
373,Jagdalpur  &,2001,26.38,103123,18545,21.92650571070491,52909,50214
373,Jagdalpur  &,2011,50.49,125463,22340,21.663450442675252,63989,61474
374,Gudiyatham UA $,1961,4.71,50384,4717,10.329121685243173,25331,25053
374,Gudiyatham UA $,1971,8.02,66537,16153,32.05978088281994,33746,32791
374,Gudiyatham UA $,1981,8.02,79038,12501,18.7880427431354,39973,39065
374,Gudiyatham UA $,1991,7.9399999999999995,88438,9400,11.893013487183381,44386,44052
374,Gudiyatham UA $,2001,13.71,100115,11677,13.203600262330673,49794,50321
374,Gudiyatham UA $,2011,17.343,124249,24134,24.106277780552364,61500,62749
375,Dimapur,1961,0.41,5753,NA,NA,3595,2158
375,Dimapur,1971,15.9,12426,6673,115.99165652702939,8413,4013
375,Dimapur,1981,18.13,32878,20452,164.5903750201191,20344,12534
375,Dimapur,1991,25.54,57182,24304,73.92177139728695,32240,24942
375,Dimapur,2001,25.54,98096,40914,71.5504879157777,53743,44353
375,Dimapur,2011,18.13,122834,24738,25.21815364540858,64300,58534
376,Jangipur U.A.,1961,7.77,24201,5946,32.57189811010682,12366,11835
376,Jangipur U.A.,1971,7.77,29872,5671,23.43291599520681,15342,14530
376,Jangipur U.A.,1981,7.77,43795,13923,46.608864488484194,22029,21766
376,Jangipur U.A.,1991,7.77,55981,12186,27.825094188834342,28655,27326
376,Jangipur U.A.,2001,9.01,80337,24356,43.507618656329825,40805,39532
376,Jangipur U.A.,2011,17.485799999999998,122731,42394,52.77020550929211,62644,60087
377,Dharmavaram,1961,36.42,20405,5702,38.781201115418625,10518,9887
377,Dharmavaram,1971,36.42,30876,10471,51.31585395736339,15768,15108
377,Dharmavaram,1981,36.42,50969,20093,65.07643477134344,26200,24769
377,Dharmavaram,1991,40.45,78961,27992,54.919657046439994,40714,38247
377,Dharmavaram,2001,40.45,103357,24396,30.89626524486772,52785,50572
377,Dharmavaram,2011,40.45,121874,18517,17.91557417494703,62250,59624
378,Kashipur,1961,3.11,24258,7661,46.16,13056,11202
378,Kashipur,1971,3.11,33457,9199,37.92,18022,15435
378,Kashipur,1981,5.46,51773,18316,54.74,27854,23919
378,Kashipur,1991,5.46,69870,18097,34.95,37441,32429
378,Kashipur,2001,5.46,92967,23097,33.06,48943,44024
378,Kashipur,2011,5.5,121623,28656,30.82384071767401,63609,58014
379,Sawai Madhopur *,1961,7.87,20952,9535,83.51580975737934,11486,9466
379,Sawai Madhopur *,1971,31.45,43284,22332,106.5864833906071,23469,19815
379,Sawai Madhopur *,1981,59,59083,15799,36.50078550965715,31961,27122
379,Sawai Madhopur *,1991,60.38,77690,18607,31.49298444561041,41752,35938
379,Sawai Madhopur *,2001,60.39,101997,24307,31.287166945552837,53903,48094
379,Sawai Madhopur *,2011,59,121106,19109,18.734864750924046,63014,58092
380,Ambikapur U.A.,1961,4.87,15240,4878,47.075854082223515,8267,6973
380,Ambikapur U.A.,1971,5.51,23740,8500,55.77427821522309,12514,11226
380,Ambikapur U.A.,1981,10.03,38291,14551,61.29317607413648,20363,17928
380,Ambikapur U.A.,1991,10.03,53227,14936,39.00655506515891,27947,25280
380,Ambikapur U.A.,2001,21.3,90967,37740,70.9038645800064,47559,43408
380,Ambikapur U.A.,2011,40.17,121071,30104,33.09331955544319,62776,58295
381,Ghazipur U.A.,1961,13.73,37147,3649,10.89,19581,17566
381,Ghazipur U.A.,1971,13.73,45635,8488,22.85,24414,21221
381,Ghazipur U.A.,1981,13.73,60725,15090,33.07,32420,28305
381,Ghazipur U.A.,1991,13.73,76547,15822,26.06,40552,35995
381,Ghazipur U.A.,2001,20.11,103298,26751,34.95,54371,48927
381,Ghazipur U.A.,2011,20.3,121020,17722,17.15618889039478,63513,57507
382,Medininagar U.A.,1961,9.07,25270,6047,31.45710867190345,14044,11226
382,Medininagar U.A.,1971,3.45,32367,7097,28.08468539770479,17695,14672
382,Medininagar U.A.,1981,3.45,51952,19585,60.509160564772756,28706,23246
382,Medininagar U.A.,1991,3.45,56323,4371,8.413535571296581,30543,25780
382,Medininagar U.A.,2001,3.45,71422,15099,26.807876000923248,37950,33472
382,Medininagar U.A.,2011,23.96,120325,48903,68.47049928593431,63641,56684
383,Churu UA,1961,62.81,41727,1680,4.195070791819612,21486,20241
383,Churu UA,1971,63.26,53185,11458,27.45943873271503,27748,25437
383,Churu UA,1981,68,62070,8885,16.705838112249694,32746,29324
383,Churu UA,1991,28.8,82852,20782,33.48155308522636,43649,39203
383,Churu UA,2001,30.35,101874,19022,22.959011248974072,53079,48795
383,Churu UA,2011,41.65,120157,18283,17.946679231207177,61774,58383
384,Kothagudem U.A.,1961,49.99,69728,19533,38.914234485506526,36369,33359
384,Kothagudem U.A.,1971,25.9,75542,5814,8.338113813676,38865,36677
384,Kothagudem U.A.,1981,25.9,94894,19352,25.617537264038546,48203,46691
384,Kothagudem U.A.,1991,34.84,102137,7243,7.632727042805657,50998,51139
384,Kothagudem U.A.,2001,24.6,105266,3129,3.0635323144404083,52318,52948
384,Kothagudem U.A.,2011,36.35,119501,14235,13.522884882108183,58625,60876
385,Chirkunda  U.A.,1961,19.14,42722,NA,NA,25492,17230
385,Chirkunda  U.A.,1971,19.53,49093,6371,14.912691353401058,28285,20808
385,Chirkunda  U.A.,1981,19.53,67203,18110,36.88916953537164,37923,29280
385,Chirkunda  U.A.,1991,18.26,59278,-7925,-11.79262830528399,32928,26350
385,Chirkunda  U.A.,2001,25.74,106227,46949,79.2013900603934,56536,49691
385,Chirkunda  U.A.,2011,22.59,118777,12550,11.814322159149745,62315,56462
386,Nawada U.A.,1961,9.66,17468,7077,68.1070156866519,9306,8162
386,Nawada U.A.,1971,5.68,23746,6278,35.94000457980307,12348,11398
386,Nawada U.A.,1981,5.68,38759,15013,63.223279710266986,20479,18280
386,Nawada U.A.,1991,5.68,53174,14415,37.19136200624371,28294,24880
386,Nawada U.A.,2001,5.68,81891,28717,54.00571707977583,43560,38331
386,Nawada U.A.,2011,8.82,118768,36877,45.031810577474936,62446,56322
387,Barshi,1961,75.16,50389,8540,20.406700279576572,26124,24265
387,Barshi,1971,36.26,62374,11985,23.784953065153108,33024,29350
387,Barshi,1981,36.26,72537,10163,16.293647994356622,38099,34438
387,Barshi,1991,36.27,88810,16273,22.434068130747068,45880,42930
387,Barshi,2001,36.26,104785,15975,17.987839207296474,53848,50937
387,Barshi,2011,36.26,118722,13937,13.30056782936489,60801,57921
388,Jhunjhunun,1961,62.13,24962,4325,20.957503513107525,13229,11733
388,Jhunjhunun,1971,3.08,32024,7062,28.291002323531767,16870,15154
388,Jhunjhunun,1981,9.64,47177,15153,47.317636772420684,24423,22754
388,Jhunjhunun,1991,3.08,72187,25010,53.01312080039003,37968,34219
388,Jhunjhunun,2001,37.02,100485,28298,39.20096416252234,52781,47704
388,Jhunjhunun,2011,50,118473,17988,17.901179280489625,61548,56925
389,Chikmagalur,1961,7.25,30253,8509,39.132634289919054,15968,14285
389,Chikmagalur,1971,7.25,41639,11386,37.63593693187454,21611,20028
389,Chikmagalur,1981,9.32,60582,18943,45.493407622661465,31470,29112
389,Chikmagalur,1991,9.32,60816,234,0.3862533425770067,31460,29356
389,Chikmagalur,2001,32.74,101251,40435,66.48743751644304,51694,49557
389,Chikmagalur,2011,32.74,118401,17150,16.938104315019118,58702,59699
390,Jetpur Navagadh,1961,10.36,31186,2742,9.639994374912108,15678,15508
390,Jetpur Navagadh,1971,10.36,41943,10757,34.493041749502986,21427,20516
390,Jetpur Navagadh,1981,10.36,63074,21131,50.380277996328346,32430,30644
390,Jetpur Navagadh,1991,10.36,95297,32223,51.087611377112594,49537,45760
390,Jetpur Navagadh,2001,36,104312,9015,9.459899052436068,54768,49544
390,Jetpur Navagadh,2011,36,118302,13990,13.411688012884424,62174,56128
391,Gudivada,1961,6.97,44801,12859,40.257341431344315,22776,22025
391,Gudivada,1971,6.94,61068,16267,36.309457378183524,30908,30160
391,Gudivada,1981,6.94,80198,19130,31.32573524595533,40386,39812
391,Gudivada,1991,12.67,101656,21458,26.75627821142672,50939,50717
391,Gudivada,2001,12.67,113054,11398,11.212323915951837,55867,57187
391,Gudivada,2011,12.67,118167,5113,4.522617510216357,59062,59105
392,Baran,1961,19.53,22764,2345,11.484401782653421,11986,10778
392,Baran,1971,19.52,29809,7045,30.947988051309096,15931,13878
392,Baran,1981,13.88,42000,12191,40.897044516756694,22531,19469
392,Baran,1991,13.88,57719,15719,37.42619047619047,30379,27340
392,Baran,2001,13.88,78665,20946,36.28961000710339,41143,37522
392,Baran,2011,72.36,117992,39327,49.99300832644761,61071,56921
393,Hoshangabad,1961,4.79,19284,4295,28.65,10423,8861
393,Hoshangabad,1971,6.84,29434,10150,52.63,15877,13557
393,Hoshangabad,1981,6.84,46300,16866,57.3,24752,21548
393,Hoshangabad,1991,24.27,70914,24614,53.16,37702,33212
393,Hoshangabad,2001,24.27,97424,26510,37.38,51756,45668
393,Hoshangabad,2011,24.27,117988,20564,21.107735260305468,61716,56272
394,Amreli UA,1961,5.18,34699,6873,24.699920937252926,18064,16635
394,Amreli UA,1971,NA,43794,9095,26.211130003746508,22979,20815
394,Amreli UA,1981,NA,58241,14447,32.98853724254464,30335,27906
394,Amreli UA,1991,NA,69366,11125,19.101663776377467,35751,33615
394,Amreli UA,2001,64.99,95307,25941,37.397283971974744,49351,45956
394,Amreli UA,2011,64.99,117967,22660,23.77579820999507,59902,58065
395,Phagwara U.A.,1961,NA,37929,12338,48.21226212340275,20573,17356
395,Phagwara U.A.,1971,NA,55012,17083,45.03941575048116,30015,24997
395,Phagwara U.A.,1981,NA,75961,20949,38.080782374754605,42127,33834
395,Phagwara U.A.,1991,NA,88316,12355,16.264925422256148,47892,40424
395,Phagwara U.A.,2001,NA,102253,13937,15.78083246523847,55335,46918
395,Phagwara U.A.,2011,NA,117966,15713,15.366786304558303,62051,55915
396,Pudukkottai,1961,12.9512,50488,5961,13.387382936196015,25738,24750
396,Pudukkottai,1971,12.09,66384,15896,31.484709237838693,33926,32458
396,Pudukkottai,1981,12.13,87952,21568,32.48975656784767,44821,43131
396,Pudukkottai,1991,12.95,99058,11106,12.627342186647262,50192,48866
396,Pudukkottai,2001,12.95,109217,10159,10.255607825718267,54614,54603
396,Pudukkottai,2011,12.95,117630,8413,7.7030132671653675,58737,58893
397,Narasaraopet U.A.,1961,6.81,29744,7501,33.7229690239626,15449,14295
397,Narasaraopet U.A.,1971,6.81,43467,13723,46.137036040882194,22436,21031
397,Narasaraopet U.A.,1981,7.48,67032,23565,54.21354130719857,34307,32725
397,Narasaraopet U.A.,1991,7.65,88726,21694,32.36364721327127,44996,43730
397,Narasaraopet U.A.,2001,7.65,95349,6623,7.4645537948290235,47994,47355
397,Narasaraopet U.A.,2011,7.65,117489,22140,23.219960356165245,59424,58065
398,Vaniyambadi UA,1961,15.62,50691,11979,30.94389336639802,25087,25604
398,Vaniyambadi UA,1971,15.95,61973,11282,22.25641632636957,31081,30892
398,Vaniyambadi UA,1981,15.92,71716,9743,15.721362528843205,35705,36011
398,Vaniyambadi UA,1991,16.47,88036,16320,22.756428133192035,43690,44346
398,Vaniyambadi UA,2001,16.1,103950,15914,18.076695897132993,51886,52064
398,Vaniyambadi UA,2011,16.63,117019,13069,12.572390572390571,57839,59180
399,Baripada U.A. *,1961,8,20301,11024,118.83,11407,8894
399,Baripada U.A. *,1971,8,28725,8424,41.5,15890,12835
399,Baripada U.A. *,1981,29.98,52989,24264,84.47,28824,24165
399,Baripada U.A. *,1991,29.98,69240,16251,30.67,37363,31877
399,Baripada U.A. *,2001,37.69,100651,31411,45.37,53606,47045
399,Baripada U.A. *,2011,39.7,116849,16198,16.093233052826104,60489,56360
400,Muktsar,1961,2.59,30765,8668,39.22704439516676,16513,14252
400,Muktsar,1971,2.59,39403,8638,28.07736063708759,20931,18472
400,Muktsar,1981,13.8,50941,11538,29.282034362865762,26554,24387
400,Muktsar,1991,13.8,66383,15442,30.313499931293066,34831,31552
400,Muktsar,2001,17.73,83655,17272,26.018709609387948,44172,39483
400,Muktsar,2011,32.8,116747,33092,39.55770725001494,61725,55022
401,Barnala,1961,12.95,21354,5358,33.49587396849212,11529,9825
401,Barnala,1971,10.36,31847,10493,49.138334738222355,17124,14723
401,Barnala,1981,16,43680,11833,37.155776054259434,23387,20293
401,Barnala,1991,16,75430,31750,72.68772893772895,40831,34599
401,Barnala,2001,26,96624,21194,28.09757390958505,52569,44055
401,Barnala,2011,26,116449,19825,20.52,62554,53895
402,Chittaurgarh,1961,23.26,16888,5025,42.35859394756807,9233,7655
402,Chittaurgarh,1971,24.31,25917,9029,53.46399810516343,14425,11492
402,Chittaurgarh,1981,56.32,44990,19073,73.5926226029247,24605,20385
402,Chittaurgarh,1991,41.76,71569,26579,59.077572793954204,38483,33086
402,Chittaurgarh,2001,41.76,96219,24650,34.44228646481017,50440,45779
402,Chittaurgarh,2011,41.76,116406,20187,20.980263773267225,60068,56338
403,Makrana U.A.,1961,33.18,17270,3327,23.8614358459442,9202,8068
403,Makrana U.A.,1971,31.54,23243,5973,34.5859872611465,12278,10965
403,Makrana U.A.,1981,7.13,40663,17420,74.947295960074,21524,19139
403,Makrana U.A.,1991,3.43,66720,26057,64.08036790202397,35330,31390
403,Makrana U.A.,2001,36.25,91853,25133,37.6693645083933,47847,44006
403,Makrana U.A.,2011,61.5,116295,24442,26.609909311617486,59947,56348
404,Azamgarh U.A.,1961,10.54,32391,5759,21.62,18486,13905
404,Azamgarh U.A.,1971,10.54,40963,8572,26.46,22535,18428
404,Azamgarh U.A.,1981,12.71,66523,25560,62.4,36024,30499
404,Azamgarh U.A.,1991,12.71,78567,12044,18.11,42454,36113
404,Azamgarh U.A.,2001,12.71,93521,14954,19.03,49564,43957
404,Azamgarh U.A.,2011,14.06,116172,22651,24.220228611755648,60551,55621
405,Sultanpur U.A.,1961,6.99,26081,8585,49.07,14568,11513
405,Sultanpur U.A.,1971,6.99,32330,6249,23.96,17809,14521
405,Sultanpur U.A.,1981,6.99,48782,16452,50.89,26625,22157
405,Sultanpur U.A.,1991,12,76533,27751,56.89,41633,34900
405,Sultanpur U.A.,2001,12.01,100065,23532,30.75,53189,46876
405,Sultanpur U.A.,2011,14.95,115944,15879,15.868685354519563,60717,55227
406,Bijnor U.A.,1961,3.65,33821,3175,10.36,18037,15784
406,Bijnor U.A.,1971,3.65,43290,9469,28,23170,20120
406,Bijnor U.A.,1981,3.65,56713,13423,31.01,30276,26437
406,Bijnor U.A.,1991,4.42,73900,17187,30.31,39166,34734
406,Bijnor U.A.,2001,5.88,96836,22936,31.036535859269282,51112,45724
406,Bijnor U.A.,2011,6.15,115256,18420,19.02185137758685,60497,54759
407,Chalakudy U.A.,1961,8.91,16864,6017,55.47155895639347,8528,8336
407,Chalakudy U.A.,1971,25.23,37562,20698,122.73481973434535,18722,18840
407,Chalakudy U.A.,1981,25.23,41894,4332,11.532932218731696,20682,21212
407,Chalakudy U.A.,1991,35.36,61672,19778,47.20962428987445,30549,31123
407,Chalakudy U.A.,2001,35.36,65835,4163,6.750227007393955,32242,33593
407,Chalakudy U.A.,2011,68.28999999999999,114863,49028,74.47102604997342,55185,59678
408,Panaji U.A,1971,37,59258,23790,67.07,30948,28310
408,Panaji U.A,1981,45.96,77226,17968,30.32,40086,37140
408,Panaji U.A,1991,76.29,90470,13244,17.15,47516,42954
408,Panaji U.A,2001,76.29,99677,9207,10.18,51106,48571
408,Panaji U.A,2011,59.37,114759,15082,15.13,59305,55454
409,Basti,1961,19.42,38403,5200,15.66,21715,16688
409,Basti,1971,19.43,49635,11232,29.25,27869,21766
409,Basti,1981,19.43,69465,19830,39.95,38034,31431
409,Basti,1991,19.43,87371,17906,25.78,47106,40265
409,Basti,2001,19.43,107601,20230,23.15,57053,50548
409,Basti,2011,19.47,114657,7056,6.557559873978866,60095,54562
410,Gangawati U.A.,1961,23.83,19026,2763,16.98948533480909,9764,9262
410,Gangawati U.A.,1971,11.66,34647,15621,82.10343740145066,17795,16852
410,Gangawati U.A.,1981,3.77,58735,24088,69.52405691690478,30126,28609
410,Gangawati U.A.,1991,29.99,81156,22421,38.17315059164042,41477,39679
410,Gangawati U.A.,2001,15.78,101392,20236,24.934693676376355,51211,50181
410,Gangawati U.A.,2011,9.21,114642,13250,13.068092157172174,57230,57412
411,Kothamangalam U.A.,1961,19.76,22900,5084,28.536147283340817,11837,11063
411,Kothamangalam U.A.,1971,18.95,28671,5771,25.200873362445414,14667,14004
411,Kothamangalam U.A.,1981,50.63,58435,29764,103.81221443270204,29409,29026
411,Kothamangalam U.A.,1991,53.22,63130,4695,8.034568323778558,31561,31569
411,Kothamangalam U.A.,2001,53.22,66419,3289,5.209884365594805,32858,33561
411,Kothamangalam U.A.,2011,81.42,114639,48220,72.59970791490386,56804,57835
412,Ambur,1961,18.65,39455,-537,-1.342768553710742,19400,20055
412,Ambur,1971,13.92,54011,14556,36.89266252692941,26963,27048
412,Ambur,1981,18.78,66042,12031,22.275092110866304,33221,32821
412,Ambur,1991,18.05,75911,9869,14.943520789800429,37893,38018
412,Ambur,2001,17.97,99624,23713,31.237897010973377,49303,50321
412,Ambur,2011,17.97,114608,14984,15.040552477314703,56382,58226
413,Itarsi UA 42,1961,7.77,33611,8816,35.56,18193,15418
413,Itarsi UA 42,1971,12.08,46866,13255,39.44,25211,21655
413,Itarsi UA 42,1981,19.16,69619,22753,48.55,37035,32584
413,Itarsi UA 42,1991,16.95,84626,15007,21.56,44475,40151
413,Itarsi UA 42,2001,24.45,107831,23205,27.42,56347,51484
413,Itarsi UA 42,2011,24.45,114495,6664,6.180040990067791,59438,55057
414,Chandausi,1961,4.92,48557,11868,32.35,26073,22484
414,Chandausi,1971,8.81,53393,4836,9.96,29077,24316
414,Chandausi,1981,8.81,66970,13577,25.43,35901,31069
414,Chandausi,1991,8.8,82748,15778,23.56,44004,38744
414,Chandausi,2001,8.8,103749,21001,25.38,55127,48622
414,Chandausi,2011,8.8,114383,10634,10.249737346865993,60256,54127
415,Siddipet U.A.,1961,13.34,18719,610,3.3684908056767355,9675,9044
415,Siddipet U.A.,1971,13.34,26296,7577,40.47758961482985,13556,12740
415,Siddipet U.A.,1981,13.34,42755,16459,62.59126863401278,22052,20703
415,Siddipet U.A.,1991,13.34,54091,11336,26.513858028300785,27455,26636
415,Siddipet U.A.,2001,3.19,61809,7718,14.268547447819415,31109,30700
415,Siddipet U.A.,2011,47.78,114091,52282,84.5863870957304,56769,57322
416,Bagaha,1961,28.59,19411,13591,233.52233676975948,10094,9317
416,Bagaha,1971,28.41,25344,5933,30.56514347534903,13252,12092
416,Bagaha,1981,25.49,32597,7253,28.61821338383838,17126,15471
416,Bagaha,1991,46.83,64627,32030,98.26057612663742,34815,29812
416,Bagaha,2001,46.83,91467,26840,41.53062961301004,48526,42941
416,Bagaha,2011,46.83,112634,21167,23.141679512829764,59614,53020
417,Achalpur [19],1961,67.88,54028,3234,6.366893727605623,28079,25949
417,Achalpur [19],1971,16.58,66451,12423,22.993632931072778,34460,31991
417,Achalpur [19],1981,17.87,81186,14735,22.174233645844307,41868,39318
417,Achalpur [19],1991,16.54,96229,15043,18.529056733919642,49594,46635
417,Achalpur [19],2001,16.54,107316,11087,11.521474815284375,55687,51629
417,Achalpur [19],2011,16.54,112311,4995,4.654478362965448,58108,54203
418,Gondal,1961,6.48,45069,8023,21.65685904011229,23324,21745
418,Gondal,1971,7.29,55329,10260,22.76509352326433,28824,26505
418,Gondal,1981,7.29,66818,11489,20.764879177284968,34074,32744
418,Gondal,1991,7.29,81611,14793,22.139243916309976,42175,39436
418,Gondal,2001,11.59,97506,15895,19.47654115254071,51110,46396
418,Gondal,2011,74.48,112197,14691,15.06676512214633,58300,53897
419,Bagalkot,1961,16.84,39934,7649,23.692117082236337,21118,18816
419,Bagalkot,1971,19.79,51746,11812,29.57880502829667,27265,24481
419,Bagalkot,1981,33.59,67858,16112,31.136706218838185,35304,32554
419,Bagalkot,1991,33.59,76903,9045,13.329305314038137,40158,36745
419,Bagalkot,2001,49.06,90988,14085,18.315280288155208,46796,44192
419,Bagalkot,2011,49.06,111933,20945,23.019519057458112,56378,55555
420,Osmanabad,1961,63.27,18868,3861,25.727993602985272,9948,8920
420,Osmanabad,1971,63.27,27279,8411,44.57812168751325,14303,12976
420,Osmanabad,1981,11.52,39068,11789,43.216393562813884,20391,18677
420,Osmanabad,1991,12.06,68019,28951,74.10412613903962,36381,31638
420,Osmanabad,2001,12.06,80625,12606,18.533056939972656,41982,38643
420,Osmanabad,2011,94.07,111825,31200,38.69767441860465,57824,54001
421,Ballia U.A.,1961,16.06,38216,7578,24.73,21509,16707
421,Ballia U.A.,1971,16.11,47101,8885,23.25,25953,21148
421,Ballia U.A.,1981,16.11,61704,14603,31,33396,28308
421,Ballia U.A.,1991,16.11,84063,22359,36.24,44901,39162
421,Ballia U.A.,2001,16.11,101465,17402,20.7,54496,46969
421,Ballia U.A.,2011,17,111487,10022,9.877297590302074,59109,52378
422,Akbarpur,1961,3.26,9563,1357,16.54,5147,4416
422,Akbarpur,1971,3.26,12516,2953,30.88,6651,5865
422,Akbarpur,1981,5,19469,6953,55.55,10303,9166
422,Akbarpur,1991,5,26878,7409,38.06,14222,12656
422,Akbarpur,2001,5,33906,7028,26.15,17695,16211
422,Akbarpur,2011,72.47,111447,77541,228.694036453725,57330,54117
423,Deesa,1961,13.8,18891,8245,77.44692842382115,9875,9016
423,Deesa,1971,8.43,28324,9433,49.933830924778995,14784,13540
423,Deesa,1981,8.43,41730,13406,47.330885468154214,21683,20047
423,Deesa,1991,8.43,62435,20705,49.61658279415288,32589,29846
423,Deesa,2001,8.43,83382,20947,33.55009209577961,44024,39358
423,Deesa,2011,20.81,111160,27778,33.31414453958888,58657,52503
424,Nandurbar,1961,35.51,41055,10911,36.19625796178344,21111,19944
424,Nandurbar,1971,9.97,54070,13015,31.701376202654973,28029,26041
424,Nandurbar,1981,31.71,65394,11324,20.943221749583874,34012,31382
424,Nandurbar,1991,31.41,78378,12984,19.85503257179558,40808,37570
424,Nandurbar,2001,31.41,94368,15990,20.401132970986758,49118,45250
424,Nandurbar,2011,31.41,111037,16669,17.663826720922344,57412,53625
425,Buxar U.A.,1961,7.87,23068,4981,27.53911649250843,12353,10715
425,Buxar U.A.,1971,6.08,31691,8623,37.38078723773192,17299,14392
425,Buxar U.A.,1981,6.08,42952,11261,35.53374775172762,23265,19687
425,Buxar U.A.,1991,5.16,55753,12801,29.803035947103744,30168,25585
425,Buxar U.A.,2001,5.16,83168,27415,49.172241852456374,44528,38640
425,Buxar U.A.,2011,6.17,110881,27713,33.32171027318199,58393,52488
426,Nagaur U.A.,1961,31.94,24296,4708,24.035123545027574,12582,11714
426,Nagaur U.A.,1971,4.05,36448,12152,50.01646361540995,19623,16825
426,Nagaur U.A.,1981,31.84,48005,11557,31.70818700614575,25597,22408
426,Nagaur U.A.,1991,37.81,68194,20189,42.056035829601086,36662,31532
426,Nagaur U.A.,2001,40.13,93915,25721,37.71739449218404,49360,44555
426,Nagaur U.A.,2011,48.38,110797,16882,17.98,56956,53841
427,Firozpur !,1961,9.22,51605,7102,15.958474709570147,28022,23583
427,Firozpur !,1971,9.22,56138,4533,8.78403255498499,30414,25724
427,Firozpur !,1981,11.33,61162,5024,8.949374755067874,32337,28825
427,Firozpur !,1991,11.33,78738,17576,28.736797357836565,41909,36829
427,Firozpur !,2001,11.33,95475,16737,21.256572430084585,50506,44969
427,Firozpur !,2011,11.33,110313,14838,15.54,58451,51862
428,Mubarakpur U.A.,1961,1.53,16133,1796,12.53,8242,7891
428,Mubarakpur U.A.,1971,1.53,21253,5120,31.74,11174,10079
428,Mubarakpur U.A.,1981,5.14,41579,20326,95.64,21745,19834
428,Mubarakpur U.A.,1991,5.14,62733,21154,50.88,32213,30520
428,Mubarakpur U.A.,2001,5.14,78789,16056,25.59,40268,38521
428,Mubarakpur U.A.,2011,13.27,109622,30833,39.13363540595768,55865,53757
429,Sehore UA,1961,2.72,28489,7610,36.45,15461,13028
429,Sehore UA,1971,14.6,36136,7647,26.84,19426,16710
429,Sehore UA,1981,16.42,52190,16054,44.43,28124,24066
429,Sehore UA,1991,16.53,71945,19755,37.85,38176,33769
429,Sehore UA,2001,16.53,92518,20573,28.6,48416,44102
429,Sehore UA,2011,15.11,109118,16600,17.942454441297908,56335,52783
430,Bongaon (M),1961,15.57,41082,17718,75.8346173600411,21702,19380
430,Bongaon (M),1971,15.57,50538,9456,23.017379874397548,26399,24139
430,Bongaon (M),1981,15.57,69885,19347,38.28208476789742,36027,33858
430,Bongaon (M),1991,15.57,79571,9686,13.859912713744007,41002,38569
430,Bongaon (M),2001,24.7,102163,22592,28.392253459174825,52537,49626
430,Bongaon (M),2011,14.27,108864,6701,6.5591261024049805,55382,53482
431,Tadpatri,1961,7.43,23129,3760,19.412463214414785,11672,11457
431,Tadpatri,1971,7.43,31618,8489,36.70284058973583,16021,15597
431,Tadpatri,1981,7.43,53920,22302,70.53577076348915,28167,25753
431,Tadpatri,1991,7.45,71068,17148,31.802670623145403,36218,34850
431,Tadpatri,2001,7.45,86843,15775,22.197050711994144,44047,42796
431,Tadpatri,2011,7.45,108171,21328,24.559262116693343,54015,54156
432,Port Blair,1961,7.87,14075,6286,80.7,8946,5129
432,Port Blair,1971,7.95,26218,12143,86.27,16832,9386
432,Port Blair,1981,14.14,49634,23416,89.31,28860,20774
432,Port Blair,1991,14.14,74955,25321,51.02,42383,32572
432,Port Blair,2001,16.91,99984,25029,33.39,55373,44611
432,Port Blair,2011,17.91,108058,8074,8.08,57761,50297
433,Shikohabad,1961,10.36,23458,3956,20.29,13028,10430
433,Shikohabad,1971,10.36,31442,7984,34.04,17457,13985
433,Shikohabad,1981,10.36,47083,15641,49.75,25594,21489
433,Shikohabad,1991,10.36,62829,15746,33.44,33771,29058
433,Shikohabad,2001,10.36,88161,25332,40.32,46862,41299
433,Shikohabad,2011,8.48,107404,19243,21.827111761436463,56794,50610
434,Shamli,1961,3.63,26397,8411,46.76,15185,11212
434,Shamli,1971,3.73,36959,10562,40.01,20432,16527
434,Shamli,1981,3.73,51850,14891,40.29,28259,23591
434,Shamli,1991,3.73,70853,19003,36.65,38032,32821
434,Shamli,2001,26.23,90055,19202,27.1,48234,41821
434,Shamli,2011,26.23,107266,17211,19.111653989228806,57187,50079
435,Koch Bihar U.A.,1961,8.29,41922,8680,26.11,23435,18487
435,Koch Bihar U.A.,1971,13.39,62664,20742,49.48,34014,28650
435,Koch Bihar U.A.,1981,17.19,80101,17437,27.83,41316,38785
435,Koch Bihar U.A.,1991,17.19,92820,12719,15.88,47305,45515
435,Koch Bihar U.A.,2001,17.19,103008,10188,10.98,52275,50733
435,Koch Bihar U.A.,2011,17.09,106843,3835,3.72,53597,53246
436,Suryapet UA,1961,4.2,16162,3719,29.88829060515953,8812,7350
436,Suryapet UA,1971,4.2,21724,5562,34.41405766613043,11551,10173
436,Suryapet UA,1981,23.65,43663,21939,100.98968882342109,23215,20448
436,Suryapet UA,1991,23.65,60630,16967,38.85898815931109,31476,29154
436,Suryapet UA,2001,24,94585,33955,56.003628566716145,49221,45364
436,Suryapet UA,2011,24,106805,12220,12.919596130464662,52773,54032
437,Margao U.A.,1971,23.72,48593,33229,216.28,25388,23205
437,Margao U.A.,1981,24.1,64858,16265,33.47,33760,31098
437,Margao U.A.,1991,22.04,72400,7542,11.63,36972,35428
437,Margao U.A.,2001,22.04,94383,21983,30.36,48061,46322
437,Margao U.A.,2011,22.09,106484,12101,12.82,54533,51951
438,Wardha,1961,7.77,49113,9286,23.315841012378538,25979,23134
438,Wardha,1971,7.77,69037,19924,40.567670474212534,36707,32330
438,Wardha,1981,7.77,88495,19458,28.184886365282384,46056,42439
438,Wardha,1991,7.77,102985,14490,16.373806429741794,53641,49344
438,Wardha,2001,7.77,111118,8133,7.897266592222168,57499,53619
438,Wardha,2011,11.84,106444,-4674,-4.206339206969168,53697,52747
439,Ranibennur,1961,6.48,31304,6022,23.81931809192311,16322,14982
439,Ranibennur,1971,6.48,40749,9445,30.171863020700243,21203,19546
439,Ranibennur,1981,3.36,58118,17369,42.624358879972505,30061,28057
439,Ranibennur,1991,5.55,67442,9324,16.043222409580522,34616,32826
439,Ranibennur,2001,42.32,89618,22176,32.88158714154386,45976,43642
439,Ranibennur,2011,42.32,106406,16788,18.732843848334042,54040,52366
440,Sitamarhi UA,1961,18.13,21636,6291,40.997067448680355,12238,9398
440,Sitamarhi UA,1971,6.63,27123,5487,25.360510260676648,15050,12073
440,Sitamarhi UA,1981,10.05,47032,19909,73.40264719979353,25764,21268
440,Sitamarhi UA,1991,10.05,67336,20304,43.170607246130295,36907,30429
440,Sitamarhi UA,2001,10.05,87279,19943,29.617143875490083,47227,40052
440,Sitamarhi UA,2011,10.05,106093,18814,21.55615898440633,56693,49400
441,Kishanganj,1961,30.04,27002,11099,69.79186317047098,15840,11162
441,Kishanganj,1971,29.46,36893,9891,36.630619954077474,20922,15971
441,Kishanganj,1981,30.12,51790,14897,40.378933673054505,28892,22898
441,Kishanganj,1991,30.12,64568,12778,24.67271674068353,34678,29890
441,Kishanganj,2001,30.12,85590,21022,32.55792342956263,46253,39337
441,Kishanganj,2011,30.12,105782,20192,23.59154106788176,55143,50639
442,Hindaun,1961,39.27,20237,5564,37.91998909561781,10851,9386
442,Hindaun,1971,12,27895,7658,37.84157730888967,14954,12941
442,Hindaun,1981,12,42706,14811,53.095536834558175,22776,19930
442,Hindaun,1991,48,60780,18074,42.32192197817636,32633,28147
442,Hindaun,2001,48,84861,24081,39.61994076999014,45490,39371
442,Hindaun,2011,48,105452,20591,24.26438528888417,55834,49618
443,Jamalpur,1961,13.88,57039,12867,29.129312686769897,30592,26447
443,Jamalpur,1971,10.65,61731,4692,8.225950665334244,33645,28086
443,Jamalpur,1981,10.65,78356,16625,26.93136349646045,42581,35775
443,Jamalpur,1991,10.65,86112,7756,9.898412374291695,47057,39055
443,Jamalpur,2001,10.65,96983,10871,12.624256781865478,51620,45363
443,Jamalpur,2011,10.65,105434,8451,8.713898312075312,56072,49362
444,Bhiwadi,1991,20,15285,NA,NA,10119,5166
444,Bhiwadi,2001,20,33877,18592,121.63559044815179,21483,12394
444,Bhiwadi,2011,44.06,104921,71044,209.71160374295243,59712,45209
445,Bundi UA,1961,30.84,26478,3781,16.65858924086882,13902,12576
445,Bundi UA,1971,22.76,34492,8014,30.266636452904294,18237,16255
445,Bundi UA,1981,22.76,48027,13535,39.24098341644441,25374,22653
445,Bundi UA,1991,22.76,65047,17020,35.43839923376436,34256,30791
445,Bundi UA,2001,27.9,88871,23824,36.62582440389258,46905,41966
445,Bundi UA,2011,29.549999999999997,104919,16048,18.05763409886238,54485,50434
446,Miryalaguda UA,1961,1.48,10024,1223,13.896148164981254,5324,4700
446,Miryalaguda UA,1971,1.47,19263,9239,92.16879489225857,10015,9248
446,Miryalaguda UA,1981,1.47,44129,24866,129.08685043866478,22860,21269
446,Miryalaguda UA,1991,21.91,65879,21750,49.28731673049469,33830,32049
446,Miryalaguda UA,2001,21,91359,25480,38.676968381426555,46770,44589
446,Miryalaguda UA,2011,21,104918,13559,14.841449665604923,52565,52353
447,Tadepalligudem UA,1961,19.01,27086,13543,100,13798,13288
447,Tadepalligudem UA,1971,19.01,43610,16524,61.00568559403382,22081,21529
447,Tadepalligudem UA,1981,20.71,62574,18964,43.48543911946801,31443,31131
447,Tadepalligudem UA,1991,20.71,88878,26304,42.03662863170007,44218,44660
447,Tadepalligudem UA,2001,20.71,102622,13744,15.463894327055064,50925,51697
447,Tadepalligudem UA,2011,20.71,104032,1410,1.373974391456023,51438,52594
448,Jagtial UA,1961,9.17,20941,-105,-0.4989071557540625,10638,10303
448,Jagtial UA,1971,9.17,30900,9959,47.55742323671267,15662,15238
448,Jagtial UA,1981,9.17,53213,22313,72.21035598705502,27511,25702
448,Jagtial UA,1991,30,67591,14378,27.01971322797061,34560,33031
448,Jagtial UA,2001,17.8,85521,17930,26.527200366912755,43377,42144
448,Jagtial UA,2011,17.8,103930,18409,21.52570713625893,51828,52102
449,Baraut,1961,10.36,22818,5890,34.794423440453684,12965,9853
449,Baraut,1971,10.36,31264,8446,37.0146375668332,16948,14316
449,Baraut,1981,10.36,46292,15028,48.06806550665302,24990,21302
449,Baraut,1991,10.36,67705,21413,46.25637259137648,36135,31570
449,Baraut,2001,10.36,85708,18003,26.590355217487634,45745,39963
449,Baraut,2011,10.36,103764,18056,21.066878237737434,55013,48751
450,Udgir,1961,20.49,18814,2292,13.872412540854617,9973,8841
450,Udgir,1971,20.49,30647,11833,62.89465291803976,16822,13825
450,Udgir,1981,20.49,50564,19917,64.98841648448462,26845,23719
450,Udgir,1991,5.8,70453,19889,39.33430899454157,37201,33252
450,Udgir,2001,5.8,91933,21480,30.488410713525326,48148,43785
450,Udgir,2011,5.8,103550,11617,12.636376491575385,54013,49537
451,Betul 44,1961,8.62,19860,4297,27.61,10556,9304
451,Betul 44,1971,10.36,30862,11002,55.4,16397,14465
451,Betul 44,1981,15.7,46293,15431,50,24531,21762
451,Betul 44,1991,17.1,63694,17401,37.59,33413,30281
451,Betul 44,2001,17.1,83722,20028,31.44,43677,40045
451,Betul 44,2011,17.1,103330,19608,23.420367406416474,52823,50507
452,Jehanabad,1961,18.83,23209,10764,86.49256729610285,12221,10988
452,Jehanabad,1971,20.23,29198,5989,25.80464474988151,15605,13593
452,Jehanabad,1981,20.23,44635,15437,52.87005959312282,23753,20882
452,Jehanabad,1991,20.23,52332,7697,17.2443149994399,28253,24079
452,Jehanabad,2001,20.23,81503,29171,55.74218451425514,43747,37756
452,Jehanabad,2011,20.23,103202,21699,26.623559868961877,54710,48492
453,Nagapattinam,1961,14.09,59063,1209,2.0897431465412937,29426,29637
453,Nagapattinam,1971,14.35,68026,8963,15.175321267121546,33428,34598
453,Nagapattinam,1981,13.29,82828,14802,21.759327316026226,41186,41642
453,Nagapattinam,1991,14.8,86489,3661,4.420002897570869,43031,43458
453,Nagapattinam,2001,14.9,93148,6659,7.699244990692458,46155,46993
453,Nagapattinam,2011,14.9,102905,9757,10.474728389230043,50793,52112
454,Tezpur UA,1961,5.1,24159,5279,27.96080508474576,15260,8899
454,Tezpur UA,1971,7.1,39870,15711,65.0316652179312,23531,16339
454,Tezpur UA,1981,NA,NA,NA,NA,NA,NA
454,Tezpur UA,1991,7.1,55084,NA,NA,30108,24976
454,Tezpur UA,2001,23.47,105377,50293,91.30237455522476,59869,45508
454,Tezpur UA,2011,26.61,102505,-2872,-2.7254524232043047,52313,50192
455,Rishikesh UA,1961,2.59,10925,3430,45.763842561707804,7409,3516
455,Rishikesh UA,1971,2.59,17646,6721,61.51945080091533,10419,7227
455,Rishikesh UA,1981,4.37,41752,24106,136.60886319845858,23440,18312
455,Rishikesh UA,1991,12.12,71704,29952,71.73788082008048,39411,32293
455,Rishikesh UA,2001,21.35,78805,7101,9.90321320986277,43183,35622
455,Rishikesh UA,2011,26.65,102469,23664,30.028551487849757,54650,47819
456,Seoni,1961,8.47,30274,5250,20.98,15715,14559
456,Seoni,1971,8.47,38396,8122,26.83,19984,18412
456,Seoni,1981,8.47,54017,15621,40.68,28489,25528
456,Seoni,1991,8.47,64532,10515,19.47,33485,31047
456,Seoni,2001,15.95,89801,25269,39.16,46310,43491
456,Seoni,2011,15.95,102343,12542,13.966436899366377,52352,49991
457,Aurangabad,1961,9.48,14154,3855,37.43081852607049,7821,6333
457,Aurangabad,1971,9.49,18714,4560,32.21704111911827,10083,8631
457,Aurangabad,1981,21.33,33192,14478,77.36453991663996,18161,15031
457,Aurangabad,1991,21.33,47565,14373,43.302603036876356,25827,21738
457,Aurangabad,2001,21.33,79393,31828,66.91474823925155,42300,37093
457,Aurangabad,2011,21.33,102244,22851,28.782134445102216,53542,48702
458,Greater Noida*,2011,20,102054,NA,NA,55540,46514
459,Hinganghat,1961,6.42,36890,4022,12.23682609224778,18943,17947
459,Hinganghat,1971,6.42,44349,7459,20.219571699647602,23091,21258
459,Hinganghat,1981,6.48,59075,14726,33.20480732372771,30619,28456
459,Hinganghat,1991,12.77,78715,19640,33.24587388912399,40633,38082
459,Hinganghat,2001,12.77,92342,13627,17.31182112685003,47945,44397
459,Hinganghat,2011,12.77,101805,9463,10.247774577115505,52577,49228
460,Dhamtari U.A.,1961,7.43,31552,14391,83.85874949012295,15734,15818
460,Dhamtari U.A.,1971,9.88,43362,11810,37.4302738336714,22074,21288
460,Dhamtari U.A.,1981,11.22,55797,12435,28.677182786771827,28313,27484
460,Dhamtari U.A.,1991,23.4,69357,13560,24.30238184848648,34819,34538
460,Dhamtari U.A.,2001,23.4,82111,12754,18.38891532217368,41237,40874
460,Dhamtari U.A.,2011,34.94,101677,19566,23.828719659972478,50807,50870
461,Sujangarh,1961,41.6,30761,4465,16.979768786127167,15300,15461
461,Sujangarh,1971,5.18,39073,8312,27.021228178537754,19545,19528
461,Sujangarh,1981,5.18,55546,16473,42.159547513628326,28297,27249
461,Sujangarh,1991,5.18,70843,15297,27.53933676592375,36410,34433
461,Sujangarh,2001,5.18,83846,13003,18.354671597758426,43072,40774
461,Sujangarh,2011,20,101523,17677,21.082699234310525,51906,49617
462,Chilakaluripet,1961,10.36,22666,11179,97.31870810481414,10988,11678
462,Chilakaluripet,1971,10.36,41543,18877,83.28333186270184,20446,21097
462,Chilakaluripet,1981,10.36,61645,20102,48.388416821125105,31169,30476
462,Chilakaluripet,1991,10.36,79142,17497,28.383486089707194,40032,39110
462,Chilakaluripet,2001,18.13,91656,12514,15.81208460741452,45619,46037
462,Chilakaluripet,2011,18.13,101398,9742,10.6288731779698,50207,51191
463,Mormugao U.A.,1971,11.66,44065,37582,579.7,26432,17633
463,Mormugao U.A.,1981,11.66,69684,25619,58.14,38355,31329
463,Mormugao U.A.,1991,39.55,90429,20745,29.77,48964,41465
463,Mormugao U.A.,2001,39.55,104758,14329,15.85,55954,48804
463,Mormugao U.A.,2011,39.6,101326,-3432,-3.28,53554,47772
464,Kasganj,1961,3.88,37559,6005,19.03,20046,17513
464,Kasganj,1971,3.89,46467,8908,23.72,24968,21499
464,Kasganj,1981,4.89,61402,14935,32.14,32812,28590
464,Kasganj,1991,4.89,75634,14232,23.18,40374,35260
464,Kasganj,2001,7.54,92541,16907,22.35,49123,43418
464,Kasganj,2011,7.54,101277,8736,9.44014004603365,53552,47725
465,Banswara U.A.,1961,20.64,19566,4008,25.76166602391052,10060,9506
465,Banswara U.A.,1971,20.65,27363,7797,39.84973934375958,14053,13310
465,Banswara U.A.,1981,32,48070,20707,75.67518181485949,25628,22442
465,Banswara U.A.,1991,16.95,67908,19838,41.26898273351364,35525,32383
465,Banswara U.A.,2001,17.39,87308,19400,28.56806267302821,45432,41876
465,Banswara U.A.,2011,17.389999999999873,101017,13709,15.70188298895863,51585,49432
466,Gangtok,1961,10,6848,4104,149.56,3908,2940
466,Gangtok,1971,NA,13308,6460,94.33,7767,5541
466,Gangtok,1981,NA,36747,23439,176.13,21387,15360
466,Gangtok,1991,NA,25024,NA,-31.9,14189,10835
466,Gangtok,2001,NA,43711,18687,74.67631074168798,23692,20019
466,Gangtok,2011,19.2,100286,56575,129.42966301388668,52459,47827
467,Datia,1961,5.18,29430,2983,11.28,15376,14054
467,Datia,1971,5.27,37436,8006,27.2,19780,17656
467,Datia,1981,4.07,49386,11950,31.92,26191,23195
467,Datia,1991,4.07,64477,15091,30.56,34045,30432
467,Datia,2001,4.07,82755,18278,28.35,43985,38770
467,Datia,2011,6.64,100284,17529,21.181801703824544,52772,47512
468,Nagda,1961,3.62,16276,NA,NA,9609,6667
468,Nagda,1971,23.83,32569,16293,100.1,17939,14630
468,Nagda,1981,23.83,56602,24033,73.79,30396,26206
468,Nagda,1991,23.83,79622,23020,40.67,42080,37542
468,Nagda,2001,23.83,96579,16957,21.3,50358,46221
468,Nagda,2011,23.83,100039,3460,3.582559355553485,51373,48666
